"","ime.priimek","n","starost","leto","mesec","dan","sezona","pozicija","klub","minute.skupno","minute.doma","minute.gostovanje","nacionalnost","nastopi.skupno","nastopi.doma","nastopi.gostovanje","goli.skupno","goli.doma","goli.gostovanje","asistence.skupno","asistence.doma","asistence.gostovanje","penal.zadet","penal.zgresen","nedotaknjena.mreza.skupno","nedotaknjena.mreza.doma","nedotaknjena.mreza.gostovanje","prejeti.zadetki.skupno","prejeti.zadetki.doma","prejeti.zadetki.gostovanje","rumeni.kartoni","rdeci.kartoni","rank.napadalci","rank.vezisti","rank.branilci"
"1","Aaron Cresswell",5,31,"1989","12","15","2017/2018","Defender","West Ham United",3073,1604,1469,"England",36,18,18,1,1,0,7,3,4,0,0,10,7,3,57,23,34,7,0,233,55,164
"2","Aaron Cresswell",5,31,"1989","12","15","2018/2019","Defender","West Ham United",1589,888,701,"England",20,11,9,0,0,0,1,1,0,0,0,3,2,1,22,12,10,1,0,290,191,80
"3","Aaron Cresswell",5,31,"1989","12","15","2019/2020","Defender","West Ham United",2730,1395,1335,"England",31,16,15,3,1,2,0,0,0,0,0,5,2,3,49,25,24,7,0,151,260,129
"4","Aaron Cresswell",5,31,"1989","12","15","2020/2021","Defender","West Ham United",3172,1552,1620,"England",36,18,18,0,0,0,8,2,6,0,0,11,6,5,40,19,21,3,0,317,32,58
"5","Aaron Cresswell",5,31,"1989","12","15","2021/2022","Defender","West Ham United",1141,540,601,"England",13,6,7,1,0,1,1,1,0,0,0,3,1,2,14,8,6,0,0,131,139,52
"6","Aaron Wan-Bissaka",5,23,"1997","11","26","2017/2018","Midfielder","Crystal Palace",628,358,270,"England",7,4,3,0,0,0,0,0,0,0,0,2,1,1,9,5,4,1,0,260,303,-1
"7","Aaron Wan-Bissaka",5,23,"1997","11","26","2018/2019","Midfielder","Crystal Palace",3135,1605,1530,"England",35,18,17,0,0,0,3,1,2,0,0,12,7,5,41,17,24,5,1,312,160,-1
"8","Aaron Wan-Bissaka",5,23,"1997","11","26","2019/2020","Midfielder","Manchester United",3071,1574,1497,"England",35,18,17,0,0,0,4,2,2,0,0,12,7,5,29,13,16,8,0,386,109,-1
"9","Aaron Wan-Bissaka",5,23,"1997","11","26","2020/2021","Midfielder","Manchester United",3060,1530,1530,"England",34,17,17,2,1,1,4,3,1,0,0,13,6,7,33,21,12,3,0,201,110,-1
"10","Aaron Wan-Bissaka",5,23,"1997","11","26","2021/2022","Midfielder","Manchester United",1170,540,630,"England",13,6,7,0,0,0,0,0,0,0,0,2,0,2,19,11,8,2,0,233,239,-1
"11","Abdoulaye Doucouré",5,28,"1993","01","01","2017/2018","Midfielder","Watford",3325,1705,1620,"France",37,19,18,7,4,3,3,3,0,0,0,9,5,4,56,29,27,10,0,101,155,-1
"12","Abdoulaye Doucouré",5,28,"1993","01","01","2018/2019","Midfielder","Watford",3062,1566,1496,"France",35,18,17,5,3,2,6,2,4,0,0,5,3,2,54,27,27,7,0,124,80,-1
"13","Abdoulaye Doucouré",5,28,"1993","01","01","2019/2020","Midfielder","Watford",3166,1655,1511,"France",37,19,18,4,1,3,2,1,1,0,0,9,7,2,57,25,32,9,0,141,199,-1
"14","Abdoulaye Doucouré",5,28,"1993","01","01","2020/2021","Midfielder","Everton",2452,1211,1241,"France",29,14,15,2,0,2,3,1,2,0,0,9,3,6,33,17,16,6,0,184,130,-1
"15","Abdoulaye Doucouré",5,28,"1993","01","01","2021/2022","Midfielder","Everton",810,360,450,"France",9,4,5,2,2,0,4,2,2,0,0,2,1,1,10,3,7,3,0,68,10,-1
"16","Adam David Lallana",5,32,"1988","05","09","2017/2018","Midfielder","Liverpool",235,64,171,"England",12,6,6,0,0,0,0,0,0,0,0,5,3,2,0,0,0,1,0,-1,-1,-1
"17","Adam David Lallana",5,32,"1988","05","10","2018/2019","Midfielder","Liverpool",465,189,276,"England",13,6,7,0,0,0,0,0,0,0,0,6,1,5,2,1,1,1,0,379,344,-1
"18","Adam David Lallana",5,32,"1988","05","10","2019/2020","Midfielder","Liverpool",373,198,175,"England",15,9,6,1,0,1,1,1,0,0,0,6,4,2,5,3,2,1,0,76,33,-1
"19","Adam David Lallana",5,33,"1988","05","10","2020/2021","Midfielder","Brighton & Hove Albion",1588,784,804,"England",30,15,15,1,1,0,1,0,1,0,0,9,5,4,17,7,10,0,0,202,183,-1
"20","Adam David Lallana",5,33,"1988","05","10","2021/2022","Midfielder","Brighton & Hove Albion",980,499,481,"England",12,6,6,0,0,0,1,0,1,0,0,4,2,2,12,7,5,4,0,204,122,-1
"21","Adrián San Miguel del Castillo",5,34,"1987","01","03","2017/2018","Goalkeeper","West Ham United",1710,900,810,"Spain",19,10,9,0,0,0,0,0,0,0,0,6,4,2,28,11,17,2,0,256,377,124
"22","Adrián San Miguel del Castillo",5,34,"1987","01","03","2018/2019","Goalkeeper","West Ham United",0,0,0,"Spain",0,0,0,0,0,0,0,0,0,0,0,0,0,0,0,0,0,0,0,-1,-1,-1
"23","Adrián San Miguel del Castillo",5,34,"1987","01","03","2019/2020","Goalkeeper","Liverpool",873,513,360,"Spain",11,7,4,0,0,0,0,0,0,0,0,2,0,2,10,8,2,1,0,343,309,44
"24","Adrián San Miguel del Castillo",5,34,"1987","01","03","2020/2021","Goalkeeper","Liverpool",270,0,270,"Spain",3,0,3,0,0,0,0,0,0,0,0,1,0,1,9,0,9,0,0,-1,-1,-1
"25","Adrián San Miguel del Castillo",5,34,"1987","01","03","2021/2022","Goalkeeper","Liverpool",0,0,0,"Spain",0,0,0,0,0,0,0,0,0,0,0,0,0,0,0,0,0,0,0,-1,-1,-1
"26","Ainsley Maitland-Niles",5,23,"1997","08","28","2017/2018","Midfielder","Arsenal",907,461,446,"England",15,7,8,0,0,0,0,0,0,0,0,5,3,2,14,7,7,1,0,286,289,-1
"27","Ainsley Maitland-Niles",5,23,"1997","08","29","2018/2019","Midfielder","Arsenal",985,462,523,"England",16,7,9,1,0,1,1,0,1,0,0,4,3,1,16,5,11,3,1,174,167,-1
"28","Ainsley Maitland-Niles",5,23,"1997","08","29","2019/2020","Midfielder","Arsenal",1382,685,697,"England",20,10,10,0,0,0,2,0,2,0,0,5,1,4,20,12,8,6,1,379,98,-1
"29","Ainsley Maitland-Niles",5,24,"1997","08","29","2020/2021","Midfielder","West Bromwich Albion",1718,788,930,"England",26,12,14,0,0,0,0,0,0,0,0,10,4,6,22,5,17,2,0,348,339,-1
"30","Ainsley Maitland-Niles",5,24,"1997","08","29","2021/2022","Midfielder","Arsenal",263,192,71,"England",8,4,4,0,0,0,0,0,0,0,0,4,2,2,4,1,3,0,0,-1,-1,-1
"31","Alex Iwobi",5,24,"1996","05","02","2017/2018","Forward","Arsenal",1843,790,1053,"Nigeria",26,11,15,3,3,0,5,4,1,0,0,9,5,4,24,9,15,1,0,122,40,-1
"32","Alex Iwobi",5,24,"1996","05","03","2018/2019","Forward","Arsenal",1972,742,1230,"Nigeria",35,18,17,3,1,2,6,3,3,0,0,8,7,1,31,8,23,0,0,128,31,-1
"33","Alex Iwobi",5,24,"1996","05","03","2019/2020","Forward","Everton",1604,754,850,"Nigeria",25,12,13,1,1,0,0,0,0,0,0,4,3,1,27,9,18,0,0,198,388,-1
"34","Alex Iwobi",5,25,"1996","05","03","2020/2021","Forward","Everton",1541,727,814,"Nigeria",30,14,16,1,0,1,2,1,1,0,0,8,2,6,19,8,11,0,0,200,123,-1
"35","Alex Iwobi",5,25,"1996","05","03","2021/2022","Forward","Everton",621,203,418,"Nigeria",11,5,6,1,0,1,1,1,0,0,0,2,1,1,15,4,11,0,0,97,90,-1
"36","Alex McCarthy",5,31,"1989","12","03","2017/2018","Goalkeeper","Southampton",1620,720,900,"England",18,8,10,0,0,0,0,0,0,0,0,4,1,3,23,10,13,2,0,283,384,77
"37","Alex McCarthy",5,31,"1989","12","03","2018/2019","Goalkeeper","Southampton",2250,1170,1080,"England",25,13,12,0,0,0,0,0,0,0,0,4,2,2,37,16,21,1,0,372,365,114
"38","Alex McCarthy",5,31,"1989","12","03","2019/2020","Goalkeeper","Southampton",2520,1260,1260,"England",28,14,14,0,0,0,0,0,0,0,0,7,3,4,33,16,17,0,0,329,354,61
"39","Alex McCarthy",5,31,"1989","12","03","2020/2021","Goalkeeper","Southampton",2700,1350,1350,"England",30,15,15,0,0,0,0,0,0,0,0,7,5,2,49,18,31,2,0,354,344,133
"40","Alex McCarthy",5,31,"1989","12","03","2021/2022","Goalkeeper","Southampton",1170,540,630,"England",13,6,7,0,0,0,0,0,0,0,0,5,3,2,17,4,13,1,0,295,294,71
"41","Alex Oxlade-Chamberlain",5,27,"1993","08","14","2017/2018","Midfielder","Liverpool",1726,835,891,"England",35,16,19,3,2,1,7,5,2,0,0,13,8,5,24,9,15,3,0,114,10,-1
"42","Alex Oxlade-Chamberlain",5,27,"1993","08","15","2018/2019","Midfielder","Liverpool",19,19,0,"England",2,2,0,0,0,0,0,0,0,0,0,2,2,0,0,0,0,0,0,-1,-1,-1
"43","Alex Oxlade-Chamberlain",5,27,"1993","08","15","2019/2020","Midfielder","Liverpool",1489,560,929,"England",30,13,17,4,2,2,1,0,1,0,0,12,5,7,12,3,9,1,0,74,192,-1
"44","Alex Oxlade-Chamberlain",5,28,"1993","08","15","2020/2021","Midfielder","Liverpool",243,121,122,"England",13,6,7,1,0,1,1,0,1,0,0,5,2,3,6,0,6,0,0,-1,-1,-1
"45","Alex Oxlade-Chamberlain",5,28,"1993","08","15","2021/2022","Midfielder","Liverpool",368,178,190,"England",8,3,5,0,0,0,1,1,0,0,0,6,2,4,4,2,2,0,0,203,41,-1
"46","Alexandre Lacazette",5,29,"1991","05","27","2017/2018","Forward","Arsenal",2212,1152,1060,"France",32,16,16,14,11,3,4,3,1,2,0,12,8,4,28,14,14,1,0,13,77,-1
"47","Alexandre Lacazette",5,29,"1991","05","28","2018/2019","Forward","Arsenal",2503,1403,1100,"France",35,19,16,13,9,4,8,4,4,0,0,7,7,0,28,10,18,2,0,21,25,-1
"48","Alexandre Lacazette",5,29,"1991","05","28","2019/2020","Forward","Arsenal",1878,998,880,"France",30,15,15,10,8,2,4,3,1,0,0,8,4,4,24,12,12,8,0,23,62,-1
"49","Alexandre Lacazette",5,30,"1991","05","28","2020/2021","Forward","Arsenal",1930,959,971,"France",31,15,16,13,3,10,2,0,2,3,0,10,4,6,21,10,11,3,0,8,141,-1
"50","Alexandre Lacazette",5,30,"1991","05","28","2021/2022","Forward","Arsenal",348,174,174,"France",8,4,4,1,1,0,0,0,0,0,0,4,2,2,4,1,3,0,0,56,179,-1
"51","Andreas Christensen",5,24,"1996","04","09","2017/2018","Defender","Chelsea",2071,943,1128,"Denmark",27,14,13,0,0,0,0,0,0,0,0,11,7,4,21,9,12,0,0,353,260,43
"52","Andreas Christensen",5,24,"1996","04","10","2018/2019","Defender","Chelsea",615,360,255,"Denmark",8,4,4,0,0,0,0,0,0,0,0,3,3,0,7,2,5,1,0,338,346,35
"53","Andreas Christensen",5,25,"1996","04","10","2019/2020","Defender","Chelsea",1754,808,946,"Denmark",21,10,11,0,0,0,0,0,0,0,0,3,3,0,32,9,23,5,0,313,408,131
"54","Andreas Christensen",5,25,"1996","04","10","2020/2021","Defender","Chelsea",1371,732,639,"Denmark",17,9,8,0,0,0,0,0,0,0,0,9,5,4,13,7,6,3,1,391,368,17
"55","Andreas Christensen",5,25,"1996","04","10","2021/2022","Defender","Chelsea",720,270,450,"Denmark",8,3,5,0,0,0,0,0,0,0,0,5,1,4,3,2,1,1,0,220,211,7
"56","Andrew Robertson",5,27,"1994","03","11","2017/2018","Defender","Liverpool",1943,1155,788,"Scotland",22,13,9,1,1,0,5,3,2,0,0,10,7,3,16,7,9,2,0,211,47,19
"57","Andrew Robertson",5,27,"1994","03","11","2018/2019","Defender","Liverpool",3219,1599,1620,"Scotland",36,18,18,0,0,0,11,9,2,0,0,21,12,9,17,7,10,4,0,418,19,2
"58","Andrew Robertson",5,27,"1994","03","11","2019/2020","Defender","Liverpool",3113,1553,1560,"Scotland",36,18,18,2,1,1,12,6,6,0,0,14,7,7,31,15,16,2,0,210,14,28
"59","Andrew Robertson",5,27,"1994","03","11","2020/2021","Defender","Liverpool",3386,1705,1681,"Scotland",38,19,19,1,1,0,7,3,4,0,0,12,5,7,40,19,21,2,0,248,59,43
"60","Andrew Robertson",5,27,"1994","03","11","2021/2022","Defender","Liverpool",780,356,424,"Scotland",9,4,5,0,0,0,2,1,1,0,0,4,1,3,11,5,6,2,0,198,47,64
"61","Andros Townsend",5,29,"1991","07","15","2017/2018","Midfielder","Crystal Palace",3128,1527,1601,"England",36,18,18,2,2,0,7,3,4,0,0,8,3,5,47,23,24,3,0,198,62,-1
"62","Andros Townsend",5,29,"1991","07","16","2018/2019","Midfielder","Crystal Palace",3018,1571,1447,"England",38,19,19,6,2,4,4,2,2,0,0,12,7,5,44,20,24,1,0,102,127,-1
"63","Andros Townsend",5,29,"1991","07","16","2019/2020","Midfielder","Crystal Palace",1290,567,723,"England",24,11,13,1,1,0,1,1,0,0,0,7,4,3,22,6,16,0,0,192,186,-1
"64","Andros Townsend",5,30,"1991","07","16","2020/2021","Midfielder","Crystal Palace",2258,1156,1102,"England",34,18,16,1,0,1,5,4,1,0,0,8,6,2,33,13,20,0,0,232,52,-1
"65","Andros Townsend",5,30,"1991","07","16","2021/2022","Midfielder","Everton",1041,506,535,"England",13,6,7,3,2,1,2,2,0,1,0,3,2,1,17,7,10,2,0,57,74,-1
"66","Angelo Ogbonna",5,32,"1988","05","22","2017/2018","Defender","West Ham United",2880,1440,1440,"Italy",32,16,16,1,0,1,0,0,0,0,0,7,5,2,56,23,33,3,0,238,390,167
"67","Angelo Ogbonna",5,32,"1988","05","23","2018/2019","Defender","West Ham United",1870,956,914,"Italy",24,12,12,1,1,0,1,1,0,0,0,3,2,1,32,13,19,2,0,226,207,124
"68","Angelo Ogbonna",5,32,"1988","05","23","2019/2020","Defender","West Ham United",2787,1260,1527,"Italy",31,14,17,2,2,0,0,0,0,0,0,7,3,4,42,20,22,4,0,214,293,105
"69","Angelo Ogbonna",5,33,"1988","05","23","2020/2021","Defender","West Ham United",2493,1143,1350,"Italy",28,13,15,3,1,2,0,0,0,0,0,9,4,5,33,15,18,5,0,146,305,72
"70","Angelo Ogbonna",5,33,"1988","05","23","2021/2022","Defender","West Ham United",922,472,450,"Italy",11,6,5,1,0,1,0,0,0,0,0,3,1,2,10,6,4,1,0,123,168,43
"71","Anthony Martial",5,25,"1995","12","05","2017/2018","Forward","Manchester United",1583,670,913,"France",30,15,15,9,5,4,5,4,1,1,0,15,10,5,13,5,8,1,0,18,22,-1
"72","Anthony Martial",5,25,"1995","12","05","2018/2019","Forward","Manchester United",1623,743,880,"France",27,11,16,10,4,6,2,1,1,1,0,5,1,4,25,8,17,2,0,13,141,-1
"73","Anthony Martial",5,25,"1995","12","05","2019/2020","Forward","Manchester United",2640,1273,1367,"France",32,16,16,17,11,6,6,5,1,0,1,12,6,6,24,13,11,1,0,16,54,-1
"74","Anthony Martial",5,25,"1995","12","05","2020/2021","Forward","Manchester United",1487,634,853,"France",22,10,12,4,3,1,3,2,1,0,0,9,4,5,19,11,8,1,1,70,64,-1
"75","Anthony Martial",5,25,"1995","12","05","2021/2022","Forward","Manchester United",198,77,121,"France",6,3,3,1,1,0,0,0,0,0,0,1,0,1,1,0,1,0,0,-1,-1,-1
"76","Antonio Rüdiger",5,28,"1993","03","03","2017/2018","Defender","Chelsea",2336,1346,990,"Germany",27,16,11,2,2,0,1,0,1,0,0,13,8,5,21,15,6,4,0,174,216,26
"77","Antonio Rüdiger",5,28,"1993","03","03","2018/2019","Defender","Chelsea",2874,1350,1524,"Germany",33,15,18,1,1,0,0,0,0,0,0,12,7,5,34,10,24,7,0,259,374,38
"78","Antonio Rüdiger",5,28,"1993","03","03","2019/2020","Defender","Chelsea",1710,900,810,"Germany",20,10,10,2,0,2,0,0,0,0,0,5,4,1,23,9,14,3,0,136,270,65
"79","Antonio Rüdiger",5,28,"1993","03","03","2020/2021","Defender","Chelsea",1710,630,1080,"Germany",19,7,12,1,1,0,0,0,0,0,0,11,5,6,10,2,8,0,0,220,371,2
"80","Antonio Rüdiger",5,28,"1993","03","03","2021/2022","Defender","Chelsea",1080,630,450,"Germany",12,7,5,2,0,2,0,0,0,0,0,7,3,4,5,4,1,2,0,90,222,10
"81","Arthur Masuaku",5,27,"1993","11","07","2017/2018","Defender","West Ham United",1872,923,949,"France",27,14,13,0,0,0,3,3,0,0,0,7,5,2,27,10,17,5,0,356,96,82
"82","Arthur Masuaku",5,27,"1993","11","07","2018/2019","Defender","West Ham United",1756,822,934,"France",23,11,12,0,0,0,1,1,0,0,0,6,3,3,26,11,15,2,0,368,203,89
"83","Arthur Masuaku",5,27,"1993","11","07","2019/2020","Defender","West Ham United",933,362,571,"France",17,7,10,0,0,0,1,1,0,0,0,5,2,3,17,9,8,6,1,262,132,132
"84","Arthur Masuaku",5,28,"1993","11","07","2020/2021","Defender","West Ham United",1011,496,515,"France",12,6,6,0,0,0,2,1,1,0,0,4,2,2,14,6,8,2,0,374,67,83
"85","Arthur Masuaku",5,28,"1993","11","07","2021/2022","Defender","West Ham United",78,4,74,"France",2,1,1,0,0,0,0,0,0,0,0,0,0,0,1,0,1,0,0,-1,-1,-1
"86","Ashley Barnes",5,31,"1989","10","30","2017/2018","Forward","Burnley",2157,1150,1007,"England",36,18,18,9,5,4,0,0,0,0,0,12,7,5,20,9,11,10,0,33,263,-1
"87","Ashley Barnes",5,31,"1989","10","30","2018/2019","Forward","Burnley",2400,1307,1093,"England",37,19,18,12,6,6,2,1,1,2,0,8,5,3,34,16,18,8,0,27,172,-1
"88","Ashley Barnes",5,31,"1989","10","30","2019/2020","Forward","Burnley",1362,750,612,"England",19,11,8,6,3,3,0,0,0,1,0,7,5,2,21,12,9,4,0,36,413,-1
"89","Ashley Barnes",5,32,"1989","10","30","2020/2021","Forward","Burnley",1336,635,701,"England",22,10,12,3,2,1,0,0,0,1,0,8,1,7,19,9,10,4,0,85,287,-1
"90","Ashley Barnes",5,32,"1989","10","30","2021/2022","Forward","Burnley",381,166,215,"England",8,4,4,0,0,0,0,0,0,0,0,1,1,0,10,3,7,2,0,208,214,-1
"91","Ashley Westwood",5,30,"1990","03","31","2017/2018","Midfielder","Burnley",1106,553,553,"England",19,9,10,0,0,0,1,1,0,0,0,5,4,1,15,5,10,2,0,302,162,-1
"92","Ashley Westwood",5,31,"1990","04","01","2018/2019","Midfielder","Burnley",2822,1530,1292,"England",34,18,16,2,0,2,7,2,5,0,0,7,5,2,44,22,22,5,0,212,55,-1
"93","Ashley Westwood",5,31,"1990","04","01","2019/2020","Midfielder","Burnley",3150,1530,1620,"England",35,17,18,2,1,1,6,4,2,0,0,15,8,7,37,16,21,9,0,201,70,-1
"94","Ashley Westwood",5,31,"1990","04","01","2020/2021","Midfielder","Burnley",3411,1701,1710,"England",38,19,19,3,0,3,3,2,1,0,0,11,3,8,54,27,27,7,0,173,165,-1
"95","Ashley Westwood",5,31,"1990","04","01","2021/2022","Midfielder","Burnley",990,540,450,"England",11,6,5,0,0,0,3,2,1,0,0,1,1,0,18,8,10,5,0,206,27,-1
"96","Aymeric Laporte",5,26,"1994","05","26","2017/2018","Defender","Manchester City",807,450,357,"France",9,5,4,0,0,0,0,0,0,0,0,4,3,1,5,2,3,1,0,272,262,7
"97","Aymeric Laporte",5,26,"1994","05","27","2018/2019","Defender","Manchester City",3057,1526,1531,"France",35,17,18,3,0,3,3,3,0,0,0,18,8,10,21,11,10,3,0,176,158,14
"98","Aymeric Laporte",5,26,"1994","05","27","2019/2020","Defender","Manchester City",1104,460,644,"France",15,7,8,1,0,1,0,0,0,0,0,11,6,5,5,2,3,1,0,175,285,1
"99","Aymeric Laporte",5,27,"1994","05","27","2020/2021","Defender","Manchester City",1342,540,802,"France",16,6,10,0,0,0,0,0,0,0,0,8,2,6,9,5,4,1,0,304,273,4
"100","Aymeric Laporte",5,27,"1994","05","27","2021/2022","Defender","Manchester City",823,463,360,"France",10,6,4,1,1,0,0,0,0,0,0,6,4,2,4,1,3,6,1,112,169,14
"101","Ayoze Perez",5,27,"1993","07","28","2017/2018","Forward","Newcastle United",2497,1190,1307,"Spain",36,18,18,8,4,4,5,2,3,0,0,9,7,2,26,8,18,3,0,59,66,-1
"102","Ayoze Perez",5,27,"1993","07","29","2018/2019","Forward","Newcastle United",2929,1526,1403,"Spain",37,19,18,12,9,3,2,1,1,0,0,11,5,6,34,21,13,2,0,44,197,-1
"103","Ayoze Perez",5,27,"1993","07","29","2019/2020","Forward","Leicester City",2019,922,1097,"Spain",33,16,17,8,3,5,4,0,4,1,0,12,7,5,23,10,13,0,0,45,66,-1
"104","Ayoze Perez",5,28,"1993","07","29","2020/2021","Forward","Leicester City",1332,695,637,"Spain",25,16,9,2,1,1,1,1,0,0,0,8,5,3,19,12,7,2,0,120,182,-1
"105","Ayoze Perez",5,28,"1993","07","29","2021/2022","Forward","Leicester City",131,79,52,"Spain",4,2,2,0,0,0,2,2,0,0,0,1,1,0,2,1,1,1,1,-1,-1,-1
"106","Ben Chilwell",5,24,"1996","12","21","2017/2018","Defender","Leicester City",1852,899,953,"England",24,12,12,0,0,0,2,0,2,0,0,6,4,2,28,10,18,3,1,339,129,91
"107","Ben Chilwell",5,24,"1996","12","21","2018/2019","Defender","Leicester City",3240,1620,1620,"England",36,18,18,0,0,0,4,1,3,0,0,10,6,4,39,15,24,4,0,344,139,44
"108","Ben Chilwell",5,24,"1996","12","21","2019/2020","Defender","Leicester City",2376,1306,1070,"England",27,15,12,3,1,2,3,1,2,0,0,10,5,5,24,15,9,3,0,144,126,29
"109","Ben Chilwell",5,24,"1996","12","21","2020/2021","Defender","Chelsea",2290,1066,1224,"England",27,13,14,3,2,1,5,3,2,0,0,13,6,7,21,10,11,3,0,135,53,16
"110","Ben Chilwell",5,24,"1996","12","21","2021/2022","Defender","Chelsea",540,270,270,"England",6,3,3,3,2,1,1,0,1,0,0,4,1,3,2,2,0,0,0,15,70,6
"111","Ben Mee",5,31,"1989","09","20","2017/2018","Defender","Burnley",2610,1170,1440,"England",29,13,16,0,0,0,0,0,0,0,0,9,4,5,23,9,14,5,0,313,277,24
"112","Ben Mee",5,31,"1989","09","21","2018/2019","Defender","Burnley",3420,1710,1710,"England",38,19,19,0,0,0,2,1,1,0,0,8,5,3,57,27,30,9,0,380,211,118
"113","Ben Mee",5,31,"1989","09","21","2019/2020","Defender","Burnley",2880,1440,1440,"England",32,16,16,1,0,1,1,0,1,0,0,13,8,5,43,18,25,7,0,253,244,98
"114","Ben Mee",5,32,"1989","09","21","2020/2021","Defender","Burnley",2694,1350,1344,"England",30,15,15,2,2,0,0,0,0,0,0,10,3,7,40,21,19,3,0,185,258,92
"115","Ben Mee",5,32,"1989","09","21","2021/2022","Defender","Burnley",810,450,360,"England",9,5,4,2,1,1,0,0,0,0,0,0,0,0,16,8,8,1,0,67,236,103
"116","Benjamin Johnson",5,21,"2000","01","24","2017/2018","Forward","West Ham United",0,0,0,"England",0,0,0,0,0,0,0,0,0,0,0,0,0,0,0,0,0,0,0,-1,-1,-1
"117","Benjamin Johnson",5,21,"2000","01","24","2018/2019","Forward","West Ham United",63,0,63,"England",1,0,1,0,0,0,0,0,0,0,0,0,0,0,1,0,1,0,0,-1,-1,-1
"118","Benjamin Johnson",5,21,"2000","01","24","2019/2020","Forward","West Ham United",270,180,90,"England",3,2,1,0,0,0,0,0,0,0,0,0,0,0,3,2,1,0,0,-1,-1,-1
"119","Benjamin Johnson",5,21,"2000","01","24","2020/2021","Forward","West Ham United",519,253,266,"England",14,8,6,1,1,0,0,0,0,0,0,3,3,0,9,2,7,1,0,105,309,-1
"120","Benjamin Johnson",5,21,"2000","01","24","2021/2022","Forward","West Ham United",540,180,360,"England",7,2,5,1,0,1,0,0,0,0,0,2,1,1,5,2,3,0,0,89,195,-1
"121","Benjamin Mendy",5,26,"1994","07","16","2017/2018","Defender","Manchester City",361,181,180,"France",7,5,2,0,0,0,1,1,0,0,0,5,4,1,1,0,1,2,0,288,35,3
"122","Benjamin Mendy",5,26,"1994","07","17","2018/2019","Defender","Manchester City",900,450,450,"France",10,5,5,0,0,0,5,3,2,0,0,4,1,3,6,4,2,1,0,311,3,12
"123","Benjamin Mendy",5,26,"1994","07","17","2019/2020","Defender","Manchester City",1497,826,671,"France",19,10,9,0,0,0,2,2,0,0,0,9,5,4,10,4,6,3,0,273,117,4
"124","Benjamin Mendy",5,27,"1994","07","17","2020/2021","Defender","Manchester City",955,508,447,"France",13,7,6,2,1,1,1,0,1,0,0,5,2,3,10,8,2,2,0,91,146,31
"125","Benjamin Mendy",5,27,"1994","07","17","2021/2022","Defender","Manchester City",79,0,79,"France",1,0,1,0,0,0,0,0,0,0,0,0,0,0,1,0,1,0,0,-1,-1,-1
"126","Bernardo Silva",5,26,"1994","08","09","2017/2018","Midfielder","Manchester City",1519,762,757,"Portugal",35,18,17,6,4,2,4,2,2,0,0,17,7,10,9,6,3,0,0,39,39,-1
"127","Bernardo Silva",5,26,"1994","08","10","2018/2019","Midfielder","Manchester City",2853,1470,1383,"Portugal",36,18,18,7,2,5,7,4,3,0,0,18,8,10,22,11,11,3,0,85,58,-1
"128","Bernardo Silva",5,26,"1994","08","10","2019/2020","Midfielder","Manchester City",2029,972,1057,"Portugal",34,17,17,6,4,2,7,3,4,0,0,16,10,6,23,8,15,5,0,62,21,-1
"129","Bernardo Silva",5,27,"1994","08","10","2020/2021","Midfielder","Manchester City",2071,891,1180,"Portugal",26,11,15,2,1,1,6,1,5,0,0,13,7,6,16,4,12,5,0,160,21,-1
"130","Bernardo Silva",5,27,"1994","08","10","2021/2022","Midfielder","Manchester City",1030,580,450,"Portugal",12,7,5,4,2,2,1,0,1,0,0,8,5,3,5,2,3,3,0,35,126,-1
"131","Callum Hudson-Odoi",5,20,"2000","11","07","2017/2018","Midfielder","Chelsea",27,27,0,"England",2,2,0,0,0,0,0,0,0,0,0,0,0,0,1,1,0,0,0,-1,-1,-1
"132","Callum Hudson-Odoi",5,20,"2000","11","07","2018/2019","Midfielder","Chelsea",391,267,124,"England",10,6,4,0,0,0,1,1,0,0,0,3,3,0,5,2,3,0,0,277,54,-1
"133","Callum Hudson-Odoi",5,20,"2000","11","07","2019/2020","Midfielder","Chelsea",851,457,394,"England",22,12,10,1,1,0,5,3,2,0,0,7,7,0,13,4,9,1,0,147,4,-1
"134","Callum Hudson-Odoi",5,21,"2000","11","07","2020/2021","Midfielder","Chelsea",1055,619,436,"England",23,10,13,2,1,1,3,1,2,0,0,12,7,5,5,1,4,0,0,104,24,-1
"135","Callum Hudson-Odoi",5,21,"2000","11","07","2021/2022","Midfielder","Chelsea",558,380,178,"England",7,5,2,1,1,0,0,0,0,0,0,4,2,2,3,3,0,0,0,93,226,-1
"136","Callum Wilson",5,29,"1992","02","27","2017/2018","Forward","AFC Bournemouth",1990,1050,940,"England",28,14,14,8,5,3,2,1,1,0,0,5,2,3,30,17,13,0,0,40,147,-1
"137","Callum Wilson",5,29,"1992","02","27","2018/2019","Forward","AFC Bournemouth",2535,1324,1211,"England",30,15,15,14,5,9,9,4,5,1,1,9,5,4,44,17,27,3,0,17,16,-1
"138","Callum Wilson",5,29,"1992","02","27","2019/2020","Forward","AFC Bournemouth",2910,1527,1383,"England",35,18,17,8,4,4,1,0,1,0,0,4,3,1,51,24,27,10,0,73,247,-1
"139","Callum Wilson",5,29,"1992","02","27","2020/2021","Forward","Newcastle United",2085,1049,1036,"England",26,13,13,12,5,7,5,3,2,4,0,4,1,3,35,19,16,2,0,14,42,-1
"140","Callum Wilson",5,29,"1992","02","27","2021/2022","Forward","Newcastle United",861,501,360,"England",10,6,4,5,4,1,0,0,0,1,0,0,0,0,20,14,6,4,0,12,162,-1
"141","Calum Chambers",5,26,"1995","01","20","2017/2018","Defender","Arsenal",869,364,505,"England",12,6,6,0,0,0,0,0,0,0,0,3,3,0,13,4,9,1,0,259,314,90
"142","Calum Chambers",5,26,"1995","01","20","2018/2019","Defender","Fulham",2587,1458,1129,"England",31,17,14,2,2,0,0,0,0,0,0,5,3,2,49,24,25,9,0,198,399,143
"143","Calum Chambers",5,26,"1995","01","20","2019/2020","Defender","Arsenal",1103,473,630,"England",14,7,7,1,1,0,1,1,0,0,0,3,1,2,15,8,7,5,0,178,159,66
"144","Calum Chambers",5,26,"1995","01","20","2020/2021","Defender","Arsenal",752,353,399,"England",10,4,6,0,0,0,2,2,0,0,0,4,1,3,10,5,5,0,0,273,30,74
"145","Calum Chambers",5,26,"1995","01","20","2021/2022","Defender","Arsenal",171,0,171,"England",2,0,2,0,0,0,0,0,0,0,0,0,0,0,7,0,7,0,0,-1,-1,-1
"146","Cedric Soares",5,29,"1991","08","30","2017/2018","Defender","Southampton",2797,1433,1364,"Portugal",32,16,16,0,0,0,3,0,3,0,0,7,3,4,41,21,20,3,0,319,130,86
"147","Cedric Soares",5,29,"1991","08","31","2018/2019","Defender","Southampton",1494,651,843,"Portugal",18,8,10,1,1,0,2,0,2,0,0,5,2,3,26,7,19,4,0,204,124,127
"148","Cedric Soares",5,29,"1991","08","31","2019/2020","Defender","Arsenal",1560,838,722,"Portugal",21,11,10,1,1,0,1,1,0,0,0,6,2,4,18,12,6,1,0,206,206,45
"149","Cedric Soares",5,30,"1991","08","31","2020/2021","Defender","Arsenal",745,410,335,"Portugal",10,6,4,0,0,0,1,1,0,0,0,2,2,0,11,6,5,1,0,279,119,91
"150","Cedric Soares",5,30,"1991","08","31","2021/2022","Defender","Arsenal",188,98,90,"Portugal",3,2,1,0,0,0,0,0,0,0,0,1,1,0,7,2,5,1,0,-1,-1,-1
"151","Cenk Tosun",5,29,"1991","06","06","2017/2018","Forward","Everton",991,503,488,"Turkey",14,6,8,5,1,4,0,0,0,0,0,4,3,1,13,5,8,0,0,25,254,-1
"152","Cenk Tosun",5,29,"1991","06","07","2018/2019","Forward","Everton",1050,536,514,"Turkey",25,13,12,3,2,1,3,1,2,0,0,7,4,3,16,9,7,3,0,74,37,-1
"153","Cenk Tosun",5,29,"1991","06","07","2019/2020","Forward","Crystal Palace",466,308,158,"Turkey",10,7,3,2,1,1,0,0,0,0,0,3,2,1,5,4,1,0,0,39,370,-1
"154","Cenk Tosun",5,30,"1991","06","07","2020/2021","Forward","Everton",43,21,22,"Turkey",5,3,2,0,0,0,0,0,0,0,0,0,0,0,2,1,1,1,0,-1,-1,-1
"155","Cenk Tosun",5,30,"1991","06","07","2021/2022","Forward","Everton",0,0,0,"Turkey",0,0,0,0,0,0,0,0,0,0,0,0,0,0,0,0,0,0,0,-1,-1,-1
"156","Cesar Azpilicueta",5,31,"1989","08","27","2017/2018","Defender","Chelsea",3330,1620,1710,"Spain",37,18,19,2,2,0,6,3,3,0,0,15,9,6,34,15,19,1,0,220,76,45
"157","Cesar Azpilicueta",5,31,"1989","08","28","2018/2019","Defender","Chelsea",3403,1693,1710,"Spain",38,19,19,1,0,1,5,3,2,0,0,16,10,6,38,12,26,4,0,260,116,33
"158","Cesar Azpilicueta",5,31,"1989","08","28","2019/2020","Defender","Chelsea",3230,1530,1700,"Spain",36,17,19,2,1,1,6,3,3,0,0,8,7,1,52,15,37,1,0,202,74,116
"159","Cesar Azpilicueta",5,32,"1989","08","28","2020/2021","Defender","Chelsea",2190,1156,1034,"Spain",26,13,13,1,1,0,2,0,2,0,0,13,7,6,18,12,6,6,1,230,155,11
"160","Cesar Azpilicueta",5,32,"1989","08","28","2021/2022","Defender","Chelsea",632,273,359,"Spain",8,4,4,0,0,0,2,2,0,0,0,5,2,3,3,2,1,0,0,219,23,11
"161","Charlie Taylor",5,27,"1993","09","17","2017/2018","Defender","Burnley",949,409,540,"England",11,5,6,0,0,0,0,0,0,0,0,3,1,2,10,6,4,3,0,301,271,49
"162","Charlie Taylor",5,27,"1993","09","18","2018/2019","Defender","Burnley",3240,1636,1604,"England",38,19,19,0,0,0,1,1,0,0,0,8,5,3,53,24,29,2,0,381,239,111
"163","Charlie Taylor",5,27,"1993","09","18","2019/2020","Defender","Burnley",1945,911,1034,"England",24,12,12,0,0,0,1,0,1,0,0,11,5,6,17,6,11,3,0,274,215,10
"164","Charlie Taylor",5,28,"1993","09","18","2020/2021","Defender","Burnley",2429,1152,1277,"England",29,14,15,0,0,0,1,1,0,0,0,10,3,7,41,19,22,1,0,378,220,117
"165","Charlie Taylor",5,28,"1993","09","18","2021/2022","Defender","Burnley",990,540,450,"England",11,6,5,0,0,0,1,1,0,0,0,1,1,0,18,8,10,0,0,217,127,93
"166","Cheikhou Kouyaté",5,31,"1989","12","21","2017/2018","Midfielder","West Ham United",2803,1481,1322,"Senegal",33,17,16,2,2,0,3,1,2,0,0,7,5,2,55,25,30,5,0,194,127,-1
"167","Cheikhou Kouyaté",5,31,"1989","12","21","2018/2019","Midfielder","Crystal Palace",1897,865,1032,"Senegal",31,14,17,0,0,0,2,1,1,0,0,11,6,5,24,7,17,3,0,323,161,-1
"168","Cheikhou Kouyaté",5,31,"1989","12","21","2019/2020","Midfielder","Crystal Palace",2536,1293,1243,"Senegal",35,17,18,1,1,0,1,1,0,0,0,9,5,4,34,13,21,4,0,232,235,-1
"169","Cheikhou Kouyaté",5,31,"1989","12","21","2020/2021","Midfielder","Crystal Palace",3122,1683,1439,"Senegal",36,19,17,1,1,0,0,0,0,0,0,8,6,2,51,25,26,4,0,251,331,-1
"170","Cheikhou Kouyaté",5,31,"1989","12","21","2021/2022","Midfielder","Crystal Palace",904,355,549,"Senegal",12,5,7,0,0,0,1,1,0,0,0,4,3,1,12,2,10,0,0,225,116,-1
"171","Chris Wood",5,29,"1991","12","07","2017/2018","Forward","Burnley",1633,807,826,"New Zealand",24,12,12,10,5,5,1,0,1,0,0,9,5,4,10,5,5,1,0,15,183,-1
"172","Chris Wood",5,29,"1991","12","07","2018/2019","Forward","Burnley",2582,1330,1252,"New Zealand",38,19,19,10,4,6,2,0,2,0,0,8,5,3,43,21,22,2,0,50,188,-1
"173","Chris Wood",5,29,"1991","12","07","2019/2020","Forward","Burnley",2446,1335,1111,"New Zealand",32,16,16,14,9,5,1,0,1,1,0,12,6,6,31,16,15,1,0,18,224,-1
"174","Chris Wood",5,29,"1991","12","07","2020/2021","Forward","Burnley",2750,1310,1440,"New Zealand",33,15,18,12,5,7,3,1,2,2,0,9,2,7,42,21,21,0,0,33,138,-1
"175","Chris Wood",5,29,"1991","12","07","2021/2022","Forward","Burnley",995,511,484,"New Zealand",12,6,6,3,3,0,0,0,0,0,0,1,1,0,20,8,12,1,0,54,213,-1
"176","Christian Benteke",5,30,"1990","12","03","2017/2018","Forward","Crystal Palace",2236,1184,1052,"Belgium",31,17,14,3,1,2,5,2,3,1,1,9,4,5,35,19,16,6,0,139,61,-1
"177","Christian Benteke",5,30,"1990","12","03","2018/2019","Forward","Crystal Palace",813,526,287,"Belgium",16,10,6,1,0,1,1,0,1,0,0,5,3,2,10,6,4,1,0,149,142,-1
"178","Christian Benteke",5,30,"1990","12","03","2019/2020","Forward","Crystal Palace",1257,584,673,"Belgium",24,11,13,2,1,1,1,0,1,0,0,8,4,4,17,7,10,5,1,116,189,-1
"179","Christian Benteke",5,30,"1990","12","03","2020/2021","Forward","Crystal Palace",1818,1013,805,"Belgium",30,16,14,10,3,7,1,1,0,0,0,6,4,2,32,18,14,3,1,18,206,-1
"180","Christian Benteke",5,30,"1990","12","03","2021/2022","Forward","Crystal Palace",881,466,415,"Belgium",14,7,7,4,1,3,1,0,1,0,0,4,3,1,11,3,8,3,0,28,115,-1
"181","Ciaran Clark",5,31,"1989","09","25","2017/2018","Defender","Newcastle United",1745,845,900,"Republic of Ireland",20,10,10,2,1,1,1,0,1,0,0,4,2,2,29,12,17,3,0,150,197,134
"182","Ciaran Clark",5,31,"1989","09","26","2018/2019","Defender","Newcastle United",857,416,441,"Republic of Ireland",11,6,5,3,1,2,0,0,0,0,0,2,0,2,14,9,5,1,0,56,315,113
"183","Ciaran Clark",5,31,"1989","09","26","2019/2020","Defender","Newcastle United",1189,586,603,"Republic of Ireland",14,7,7,2,1,1,0,0,0,0,0,4,3,1,13,4,9,3,0,110,371,36
"184","Ciaran Clark",5,32,"1989","09","26","2020/2021","Defender","Newcastle United",1893,893,1000,"Republic of Ireland",22,10,12,1,0,1,0,0,0,0,0,4,1,3,35,14,21,3,0,219,380,137
"185","Ciaran Clark",5,32,"1989","09","26","2021/2022","Defender","Newcastle United",903,459,444,"Republic of Ireland",11,6,5,0,0,0,1,0,1,0,0,0,0,0,22,14,8,3,1,158,113,124
"186","Curtis Jones",5,20,"2001","01","30","2017/2018","Midfielder","Liverpool",0,0,0,"England",0,0,0,0,0,0,0,0,0,0,0,0,0,0,0,0,0,0,0,-1,-1,-1
"187","Curtis Jones",5,20,"2001","01","30","2018/2019","Midfielder","Liverpool",0,0,0,"England",0,0,0,0,0,0,0,0,0,0,0,0,0,0,0,0,0,0,0,-1,-1,-1
"188","Curtis Jones",5,20,"2001","01","30","2019/2020","Midfielder","Liverpool",122,98,24,"England",6,3,3,1,1,0,0,0,0,0,0,3,1,2,1,1,0,0,0,-1,-1,-1
"189","Curtis Jones",5,20,"2001","01","30","2020/2021","Midfielder","Liverpool",1177,678,499,"England",24,13,11,1,0,1,2,0,2,0,0,7,4,3,11,6,5,2,0,171,95,-1
"190","Curtis Jones",5,20,"2001","01","30","2021/2022","Midfielder","Liverpool",322,191,131,"England",5,3,2,1,0,1,1,1,0,0,0,2,1,1,6,4,2,0,0,48,24,-1
"191","Daniel William John Ings",5,28,"1992","07","22","2017/2018","Forward","Liverpool",265,90,175,"England",8,4,4,1,0,1,0,0,0,0,0,5,3,2,0,0,0,0,0,-1,-1,-1
"192","Daniel William John Ings",5,28,"1992","07","23","2018/2019","Forward","Southampton",1668,922,746,"England",24,13,11,7,3,4,3,3,0,3,0,6,2,4,26,13,13,1,0,39,87,-1
"193","Daniel William John Ings",5,28,"1992","07","23","2019/2020","Forward","Southampton",2815,1459,1356,"England",38,19,19,22,10,12,2,0,2,1,1,9,3,6,42,26,16,3,0,3,202,-1
"194","Daniel William John Ings",5,29,"1992","07","23","2020/2021","Forward","Southampton",2183,1171,1012,"England",29,15,14,12,7,5,4,4,0,2,0,7,5,2,39,17,22,1,0,22,87,-1
"195","Daniel William John Ings",5,29,"1992","07","23","2021/2022","Forward","Aston Villa",829,426,403,"England",10,5,5,3,2,1,2,2,0,1,0,4,3,1,13,3,10,1,0,39,54,-1
"196","Danny Welbeck",5,30,"1990","11","26","2017/2018","Forward","Arsenal",1185,598,587,"England",28,13,15,5,5,0,2,2,0,0,0,10,6,4,19,10,9,1,0,34,79,-1
"197","Danny Welbeck",5,30,"1990","11","26","2018/2019","Forward","Arsenal",147,47,100,"England",8,4,4,1,1,0,1,0,1,0,0,2,2,0,2,0,2,0,0,-1,-1,-1
"198","Danny Welbeck",5,30,"1990","11","26","2019/2020","Forward","Watford",816,367,449,"England",18,8,10,2,1,1,0,0,0,0,0,1,1,0,12,3,9,0,0,78,381,-1
"199","Danny Welbeck",5,30,"1990","11","26","2020/2021","Forward","Brighton & Hove Albion",1547,728,819,"England",24,12,12,6,4,2,1,0,1,0,1,7,5,2,16,5,11,0,0,42,188,-1
"200","Danny Welbeck",5,30,"1990","11","26","2021/2022","Forward","Brighton & Hove Albion",241,101,140,"England",4,2,2,1,1,0,0,0,0,0,0,1,0,1,2,1,1,0,0,-1,-1,-1
"201","David de Gea",5,30,"1990","11","07","2017/2018","Goalkeeper","Manchester United",3330,1620,1710,"Spain",37,18,19,0,0,0,0,0,0,0,0,18,11,7,27,9,18,0,0,375,397,18
"202","David de Gea",5,30,"1990","11","07","2018/2019","Goalkeeper","Manchester United",3420,1710,1710,"Spain",38,19,19,0,0,0,0,0,0,0,0,7,2,5,51,23,28,1,0,310,419,91
"203","David de Gea",5,30,"1990","11","07","2019/2020","Goalkeeper","Manchester United",3420,1710,1710,"Spain",38,19,19,0,0,0,0,0,0,0,0,13,7,6,32,15,17,2,0,384,347,18
"204","David de Gea",5,31,"1990","11","07","2020/2021","Goalkeeper","Manchester United",2296,1350,946,"Spain",26,15,11,0,0,0,0,0,0,0,0,9,5,4,30,21,9,0,0,370,361,71
"205","David de Gea",5,31,"1990","11","07","2021/2022","Goalkeeper","Manchester United",1170,540,630,"Spain",13,6,7,0,0,0,0,0,0,0,0,2,0,2,19,11,8,0,0,242,249,82
"206","Davinson Sánchez Mina",5,24,"1996","06","11","2017/2018","Defender","Tottenham Hotspur",2534,1272,1262,"Colombia",31,16,15,0,0,0,0,0,0,0,0,14,9,5,20,8,12,2,1,271,253,15
"207","Davinson Sánchez Mina",5,24,"1996","06","12","2018/2019","Defender","Tottenham Hotspur",1943,873,1070,"Colombia",23,10,13,1,1,0,1,0,1,0,0,6,3,3,21,9,12,2,0,221,208,26
"208","Davinson Sánchez Mina",5,24,"1996","06","12","2019/2020","Defender","Tottenham Hotspur",2430,1306,1124,"Colombia",29,15,14,0,0,0,0,0,0,0,0,4,4,0,34,14,20,6,0,413,383,77
"209","Davinson Sánchez Mina",5,25,"1996","06","12","2020/2021","Defender","Tottenham Hotspur",1486,540,946,"Colombia",18,6,12,0,0,0,0,0,0,0,0,4,2,2,19,4,15,1,0,398,397,62
"210","Davinson Sánchez Mina",5,25,"1996","06","12","2021/2022","Defender","Tottenham Hotspur",389,209,180,"Colombia",6,4,2,0,0,0,0,0,0,0,0,3,2,1,3,0,3,1,0,184,190,22
"211","Declan Rice",5,22,"1999","01","14","2017/2018","Midfielder","West Ham United",1422,560,862,"Republic of Ireland",26,10,16,0,0,0,0,0,0,0,0,6,4,2,26,7,19,1,0,258,376,-1
"212","Declan Rice",5,22,"1999","01","14","2018/2019","Midfielder","West Ham United",3005,1440,1565,"Republic of Ireland",34,16,18,2,2,0,0,0,0,0,0,6,3,3,42,21,21,4,0,210,362,-1
"213","Declan Rice",5,22,"1999","01","14","2019/2020","Midfielder","West Ham United",3420,1710,1710,"Republic of Ireland",38,19,19,1,1,0,3,2,1,0,0,7,3,4,59,32,27,6,0,251,158,-1
"214","Declan Rice",5,22,"1999","01","14","2020/2021","Midfielder","West Ham United",2880,1440,1440,"Republic of Ireland",32,16,16,2,2,0,1,1,0,1,1,11,6,5,36,18,18,2,0,197,232,-1
"215","Declan Rice",5,22,"1999","01","14","2021/2022","Midfielder","West Ham United",1170,540,630,"Republic of Ireland",13,6,7,1,0,1,3,1,2,0,0,3,1,2,14,8,6,4,0,137,49,-1
"216","Dele Alli",5,24,"1996","04","10","2017/2018","Midfielder","Tottenham Hotspur",2972,1415,1557,"England",36,18,18,9,4,5,10,6,4,0,0,15,9,6,26,10,16,7,0,63,19,-1
"217","Dele Alli",5,24,"1996","04","11","2018/2019","Midfielder","Tottenham Hotspur",1827,755,1072,"England",25,11,14,5,1,4,3,2,1,0,0,7,3,4,17,4,13,4,0,82,97,-1
"218","Dele Alli",5,25,"1996","04","11","2019/2020","Midfielder","Tottenham Hotspur",1853,916,937,"England",25,11,14,8,5,3,4,3,1,1,0,4,3,1,24,10,14,2,0,38,57,-1
"219","Dele Alli",5,25,"1996","04","11","2020/2021","Midfielder","Tottenham Hotspur",618,320,298,"England",15,5,10,0,0,0,1,0,1,0,0,4,3,1,8,2,6,0,0,393,93,-1
"220","Dele Alli",5,25,"1996","04","11","2021/2022","Midfielder","Tottenham Hotspur",515,289,226,"England",8,5,3,1,0,1,0,0,0,1,0,3,2,1,8,3,5,1,0,91,200,-1
"221","Demarai Gray",5,24,"1996","06","27","2017/2018","Midfielder","Leicester City",1690,796,894,"England",35,17,18,3,2,1,1,0,1,0,0,9,6,3,32,11,21,2,0,113,209,-1
"222","Demarai Gray",5,24,"1996","06","28","2018/2019","Midfielder","Leicester City",1992,1069,923,"England",34,17,17,4,1,3,1,1,0,0,0,8,5,3,26,10,16,2,0,103,212,-1
"223","Demarai Gray",5,24,"1996","06","28","2019/2020","Midfielder","Leicester City",607,271,336,"England",21,10,11,2,1,1,3,0,3,0,1,8,4,4,4,1,3,1,0,52,7,-1
"224","Demarai Gray",5,25,"1996","06","28","2020/2021","Midfielder","Leicester City",18,0,18,"England",1,0,1,0,0,0,0,0,0,0,0,0,0,0,0,0,0,0,0,-1,-1,-1
"225","Demarai Gray",5,25,"1996","06","28","2021/2022","Midfielder","Everton",982,511,471,"England",13,6,7,3,1,2,2,2,0,0,0,3,2,1,12,4,8,0,0,53,67,-1
"226","Divock Origi",5,25,"1995","04","17","2017/2018","Forward","Liverpool",9,0,9,"Belgium",1,0,1,0,0,0,0,0,0,0,0,0,0,0,0,0,0,0,0,-1,-1,-1
"227","Divock Origi",5,25,"1995","04","18","2018/2019","Forward","Liverpool",366,176,190,"Belgium",12,5,7,3,2,1,1,0,1,0,0,7,4,3,2,0,2,0,0,2,42,-1
"228","Divock Origi",5,26,"1995","04","18","2019/2020","Forward","Liverpool",704,299,405,"Belgium",28,13,15,4,3,1,1,1,0,0,0,11,5,6,12,6,6,1,0,19,95,-1
"229","Divock Origi",5,26,"1995","04","18","2020/2021","Forward","Liverpool",181,92,89,"Belgium",9,6,3,0,0,0,0,0,0,0,0,2,2,0,0,0,0,0,0,-1,-1,-1
"230","Divock Origi",5,26,"1995","04","18","2021/2022","Forward","Liverpool",16,2,14,"Belgium",2,1,1,1,0,1,0,0,0,0,0,1,1,0,0,0,0,0,0,-1,-1,-1
"231","Dominic Calvert-Lewin",5,24,"1997","03","16","2017/2018","Forward","Everton",1874,941,933,"England",32,16,16,4,3,1,6,3,3,0,0,9,7,2,26,9,17,4,0,98,21,-1
"232","Dominic Calvert-Lewin",5,24,"1997","03","16","2018/2019","Forward","Everton",1774,1023,751,"England",35,18,17,6,3,3,2,2,0,0,0,13,8,5,24,12,12,3,0,65,145,-1
"233","Dominic Calvert-Lewin",5,24,"1997","03","16","2019/2020","Forward","Everton",2630,1195,1435,"England",36,17,19,13,7,6,1,1,0,0,0,8,5,3,38,10,28,9,0,28,253,-1
"234","Dominic Calvert-Lewin",5,24,"1997","03","16","2020/2021","Forward","Everton",2876,1409,1467,"England",33,16,17,16,7,9,0,0,0,0,0,11,3,8,36,17,19,3,0,17,401,-1
"235","Dominic Calvert-Lewin",5,24,"1997","03","16","2021/2022","Forward","Everton",249,90,159,"England",3,1,2,3,1,2,0,0,0,2,0,1,0,1,3,1,2,0,0,-1,-1,-1
"236","Dwight McNeil",5,21,"1999","11","22","2017/2018","Forward","Burnley",0,0,0,"England",1,1,0,0,0,0,0,0,0,0,0,0,0,0,0,0,0,0,0,-1,-1,-1
"237","Dwight McNeil",5,21,"1999","11","22","2018/2019","Forward","Burnley",1599,941,658,"England",21,12,9,3,3,0,5,3,2,0,0,4,3,1,22,12,10,2,0,112,29,-1
"238","Dwight McNeil",5,21,"1999","11","22","2019/2020","Forward","Burnley",3345,1678,1667,"England",38,19,19,2,2,0,6,4,2,0,0,15,8,7,47,21,26,5,0,219,79,-1
"239","Dwight McNeil",5,21,"1999","11","22","2020/2021","Forward","Burnley",3070,1516,1554,"England",36,18,18,2,1,1,5,1,4,0,0,10,2,8,49,24,25,1,0,204,91,-1
"240","Dwight McNeil",5,21,"1999","11","22","2021/2022","Forward","Burnley",1066,529,537,"England",12,6,6,0,0,0,1,1,0,0,0,1,1,0,20,8,12,1,0,207,144,-1
"241","Ederson",5,27,"1993","08","16","2017/2018","Goalkeeper","Manchester City",3195,1575,1620,"Brazil",36,18,18,0,0,0,0,0,0,0,0,17,8,9,24,12,12,1,0,358,362,12
"242","Ederson",5,27,"1993","08","17","2018/2019","Goalkeeper","Manchester City",3420,1710,1710,"Brazil",38,19,19,0,0,0,1,1,0,0,0,20,9,11,23,12,11,2,0,366,240,13
"243","Ederson",5,27,"1993","08","17","2019/2020","Goalkeeper","Manchester City",3072,1530,1542,"Brazil",35,17,18,0,0,0,0,0,0,0,0,16,9,7,24,10,14,4,1,357,278,6
"244","Ederson",5,28,"1993","08","17","2020/2021","Goalkeeper","Manchester City",3240,1710,1530,"Brazil",36,19,17,0,0,0,1,1,0,0,0,19,10,9,26,15,11,3,0,366,226,10
"245","Ederson",5,28,"1993","08","17","2021/2022","Goalkeeper","Manchester City",1080,540,540,"Brazil",12,6,6,0,0,0,0,0,0,0,0,7,4,3,6,2,4,2,0,193,207,17
"246","Edward Nketiah",5,21,"1999","05","29","2017/2018","Forward","Arsenal",17,0,17,"England",3,0,3,0,0,0,0,0,0,0,0,0,0,0,0,0,0,0,0,-1,-1,-1
"247","Edward Nketiah",5,21,"1999","05","30","2018/2019","Forward","Arsenal",62,4,58,"England",5,1,4,1,0,1,0,0,0,0,0,1,1,0,2,0,2,0,0,-1,-1,-1
"248","Edward Nketiah",5,21,"1999","05","30","2019/2020","Forward","Arsenal",648,316,332,"England",13,7,6,2,1,1,0,0,0,0,0,6,3,3,8,5,3,1,1,56,316,-1
"249","Edward Nketiah",5,22,"1999","05","30","2020/2021","Forward","Arsenal",413,281,132,"England",17,10,7,2,2,0,1,1,0,0,0,5,2,3,6,3,3,0,0,28,41,-1
"250","Edward Nketiah",5,22,"1999","05","30","2021/2022","Forward","Arsenal",0,0,0,"England",0,0,0,0,0,0,0,0,0,0,0,0,0,0,0,0,0,0,0,-1,-1,-1
"251","Emerson Palmieri dos Santos",5,26,"1994","08","02","2017/2018","Defender","Chelsea",279,7,272,"Italy",5,1,4,0,0,0,1,0,1,0,0,1,0,1,4,0,4,0,0,412,15,81
"252","Emerson Palmieri dos Santos",5,26,"1994","08","03","2018/2019","Defender","Chelsea",660,360,300,"Italy",10,4,6,0,0,0,0,0,0,0,0,3,2,1,10,3,7,0,0,274,296,96
"253","Emerson Palmieri dos Santos",5,26,"1994","08","03","2019/2020","Defender","Chelsea",1025,645,380,"Italy",15,8,7,0,0,0,0,0,0,0,0,1,1,0,20,10,10,3,0,367,407,144
"254","Emerson Palmieri dos Santos",5,27,"1994","08","03","2020/2021","Defender","Chelsea",89,81,8,"Italy",2,1,1,0,0,0,0,0,0,0,0,2,1,1,0,0,0,0,0,-1,-1,-1
"255","Emerson Palmieri dos Santos",5,27,"1994","08","03","2021/2022","Defender","Chelsea",4,4,0,"Italy",1,1,0,0,0,0,0,0,0,0,0,1,1,0,0,0,0,0,0,-1,-1,-1
"256","Eric Bertrand Bailly",5,26,"1994","04","11","2017/2018","Defender","Manchester United",999,549,450,"Côte d'Ivoire",13,7,6,1,0,1,0,0,0,0,0,8,5,3,6,1,5,2,0,166,400,6
"257","Eric Bertrand Bailly",5,26,"1994","04","12","2018/2019","Defender","Manchester United",637,349,288,"Côte d'Ivoire",12,5,7,0,0,0,0,0,0,0,0,3,0,3,12,6,6,1,1,340,310,141
"258","Eric Bertrand Bailly",5,27,"1994","04","12","2019/2020","Defender","Manchester United",147,56,91,"Côte d'Ivoire",4,2,2,0,0,0,0,0,0,0,0,2,1,1,1,1,0,0,0,-1,-1,-1
"259","Eric Bertrand Bailly",5,27,"1994","04","12","2020/2021","Defender","Manchester United",916,446,470,"Côte d'Ivoire",12,5,7,0,0,0,0,0,0,0,0,3,1,2,16,12,4,3,0,372,377,120
"260","Eric Bertrand Bailly",5,27,"1994","04","12","2021/2022","Defender","Manchester United",136,46,90,"Côte d'Ivoire",2,1,1,0,0,0,0,0,0,0,0,0,0,0,3,2,1,1,0,-1,-1,-1
"261","Eric Dier",5,27,"1994","01","15","2017/2018","Midfielder","Tottenham Hotspur",2827,1485,1342,"England",34,18,16,0,0,0,2,1,1,0,0,15,9,6,27,13,14,4,0,372,178,-1
"262","Eric Dier",5,27,"1994","01","15","2018/2019","Midfielder","Tottenham Hotspur",1510,674,836,"England",20,9,11,3,2,1,0,0,0,0,0,6,2,4,16,8,8,4,0,107,278,-1
"263","Eric Dier",5,27,"1994","01","15","2019/2020","Midfielder","Tottenham Hotspur",1342,742,600,"England",19,12,7,0,0,0,2,0,2,0,0,4,4,0,21,9,12,5,0,416,99,-1
"264","Eric Dier",5,27,"1994","01","15","2020/2021","Midfielder","Tottenham Hotspur",2520,1350,1170,"England",28,15,13,0,0,0,0,0,0,0,0,8,5,3,30,14,16,3,0,395,393,-1
"265","Eric Dier",5,27,"1994","01","15","2021/2022","Midfielder","Tottenham Hotspur",1002,540,462,"England",12,6,6,0,0,0,0,0,0,0,0,4,2,2,13,7,6,0,0,187,201,-1
"266","Fabian Delph",5,31,"1989","11","21","2017/2018","Midfielder","Manchester City",1746,953,793,"England",22,12,10,1,1,0,2,2,0,0,0,9,5,4,15,9,6,2,0,210,131,-1
"267","Fabian Delph",5,31,"1989","11","21","2018/2019","Midfielder","Manchester City",725,266,459,"England",11,5,6,0,0,0,1,1,0,0,0,4,1,3,9,4,5,2,1,295,123,-1
"268","Fabian Delph",5,31,"1989","11","21","2019/2020","Midfielder","Everton",1190,630,560,"England",16,8,8,0,0,0,0,0,0,0,0,3,3,0,21,8,13,5,1,299,295,-1
"269","Fabian Delph",5,31,"1989","11","21","2020/2021","Midfielder","Everton",261,81,180,"England",8,3,5,0,0,0,0,0,0,0,0,2,0,2,5,2,3,1,0,-1,-1,-1
"270","Fabian Delph",5,31,"1989","11","21","2021/2022","Midfielder","Everton",174,60,114,"England",4,1,3,0,0,0,0,0,0,0,0,1,1,0,2,0,2,1,0,-1,-1,-1
"271","Federico Fernández",5,32,"1989","02","21","2017/2018","Defender","Swansea City",2677,1260,1417,"Argentina",30,14,16,1,0,1,1,1,0,0,0,7,3,4,41,16,25,5,0,241,227,100
"272","Federico Fernández",5,32,"1989","02","21","2018/2019","Defender","Newcastle United",1484,607,877,"Argentina",19,8,11,0,0,0,1,1,0,0,0,4,1,3,22,9,13,2,0,297,194,90
"273","Federico Fernández",5,32,"1989","02","21","2019/2020","Defender","Newcastle United",2618,1355,1263,"Argentina",32,16,16,2,1,1,2,1,1,0,0,9,5,4,38,18,20,8,0,190,183,91
"274","Federico Fernández",5,32,"1989","02","21","2020/2021","Defender","Newcastle United",2083,1016,1067,"Argentina",24,12,12,0,0,0,0,0,0,0,0,5,2,3,35,19,16,4,0,321,312,115
"275","Federico Fernández",5,32,"1989","02","21","2021/2022","Defender","Newcastle United",517,259,258,"Argentina",6,3,3,0,0,0,0,0,0,0,0,0,0,0,11,6,5,0,0,151,149,116
"276","Fernando Luiz Rosa",5,35,"1985","05","03","2017/2018","Midfielder","Manchester City",2885,1387,1498,"Brazil",34,17,17,5,3,2,3,2,1,0,0,15,6,9,22,11,11,7,0,115,138,-1
"277","Fernando Luiz Rosa",5,35,"1985","05","04","2018/2019","Midfielder","Manchester City",2381,1286,1095,"Brazil",29,15,14,1,1,0,3,3,0,0,0,16,7,9,15,8,7,5,0,228,132,-1
"278","Fernando Luiz Rosa",5,35,"1985","05","04","2019/2020","Midfielder","Manchester City",2398,1165,1233,"Brazil",30,15,15,0,0,0,1,1,0,0,0,12,7,5,23,9,14,10,2,280,220,-1
"279","Fernando Luiz Rosa",5,36,"1985","05","04","2020/2021","Midfielder","Manchester City",1181,669,512,"Brazil",21,10,11,0,0,0,2,2,0,0,0,11,6,5,8,5,3,6,0,313,94,-1
"280","Fernando Luiz Rosa",5,36,"1985","05","04","2021/2022","Midfielder","Manchester City",188,74,114,"Brazil",7,3,4,1,1,0,0,0,0,0,0,4,2,2,2,0,2,0,0,-1,-1,-1
"281","Fraser Forster",5,33,"1988","03","17","2017/2018","Goalkeeper","Southampton",1800,990,810,"England",20,11,9,0,0,0,0,0,0,0,0,4,2,2,29,15,14,0,0,317,408,121
"282","Fraser Forster",5,33,"1988","03","17","2018/2019","Goalkeeper","Southampton",90,0,90,"England",1,0,1,0,0,0,0,0,0,0,0,0,0,0,3,0,3,0,0,-1,-1,-1
"283","Fraser Forster",5,33,"1988","03","17","2019/2020","Goalkeeper","Southampton",0,0,0,"England",0,0,0,0,0,0,0,0,0,0,0,0,0,0,0,0,0,0,0,-1,-1,-1
"284","Fraser Forster",5,33,"1988","03","17","2020/2021","Goalkeeper","Southampton",720,360,360,"England",8,4,4,0,0,0,0,0,0,0,0,2,1,1,10,5,5,0,0,358,349,81
"285","Fraser Forster",5,33,"1988","03","17","2021/2022","Goalkeeper","Southampton",0,0,0,"England",0,0,0,0,0,0,0,0,0,0,0,0,0,0,0,0,0,0,0,-1,-1,-1
"286","Gabriel Jesus",5,23,"1997","04","02","2017/2018","Forward","Manchester City",1672,644,1028,"Brazil",29,13,16,13,6,7,3,1,2,0,2,14,5,9,11,5,6,6,0,5,73,-1
"287","Gabriel Jesus",5,24,"1997","04","03","2018/2019","Forward","Manchester City",1019,702,317,"Brazil",29,14,15,7,5,2,3,1,2,1,0,16,7,9,11,7,4,1,0,6,33,-1
"288","Gabriel Jesus",5,24,"1997","04","03","2019/2020","Forward","Manchester City",2026,987,1039,"Brazil",34,17,17,14,6,8,7,2,5,0,1,15,8,7,10,5,5,3,0,10,19,-1
"289","Gabriel Jesus",5,24,"1997","04","03","2020/2021","Forward","Manchester City",2060,1117,943,"Brazil",29,15,14,9,5,4,4,1,3,0,0,15,8,7,15,7,8,2,0,34,76,-1
"290","Gabriel Jesus",5,24,"1997","04","03","2021/2022","Forward","Manchester City",859,398,461,"Brazil",11,5,6,2,1,1,5,3,2,0,0,6,3,3,5,2,3,0,0,72,6,-1
"291","Granit Xhaka",5,28,"1992","09","26","2017/2018","Midfielder","Arsenal",3266,1607,1659,"Switzerland",38,19,19,1,1,0,7,4,3,0,0,13,9,4,46,20,26,10,0,239,64,-1
"292","Granit Xhaka",5,28,"1992","09","27","2018/2019","Midfielder","Arsenal",2502,1317,1185,"Switzerland",29,15,14,4,2,2,2,0,2,0,0,7,6,1,35,11,24,10,0,127,183,-1
"293","Granit Xhaka",5,28,"1992","09","27","2019/2020","Midfielder","Arsenal",2590,1213,1377,"Switzerland",31,14,17,1,1,0,2,1,1,0,0,10,5,5,31,15,16,10,0,241,179,-1
"294","Granit Xhaka",5,29,"1992","09","27","2020/2021","Midfielder","Arsenal",2522,1225,1297,"Switzerland",31,15,16,1,1,0,2,1,1,0,0,10,4,6,26,12,14,8,1,234,167,-1
"295","Granit Xhaka",5,29,"1992","09","27","2021/2022","Midfielder","Arsenal",297,172,125,"Switzerland",4,2,2,0,0,0,0,0,0,0,0,0,0,0,7,3,4,1,1,238,247,-1
"296","Hamza Choudhury",5,23,"1997","09","30","2017/2018","Midfielder","Leicester City",332,206,126,"England",8,5,3,0,0,0,1,1,0,0,0,1,1,0,9,3,6,1,0,255,26,-1
"297","Hamza Choudhury",5,23,"1997","10","01","2018/2019","Midfielder","Leicester City",596,308,288,"England",9,4,5,0,0,0,0,0,0,0,0,4,2,2,4,3,1,0,0,275,297,-1
"298","Hamza Choudhury",5,23,"1997","10","01","2019/2020","Midfielder","Leicester City",889,405,484,"England",20,11,9,1,0,1,1,1,0,0,0,7,5,2,10,6,4,4,1,157,134,-1
"299","Hamza Choudhury",5,24,"1997","10","01","2020/2021","Midfielder","Leicester City",313,16,297,"England",10,3,7,0,0,0,0,0,0,0,0,2,0,2,1,0,1,1,0,336,359,-1
"300","Hamza Choudhury",5,24,"1997","10","01","2021/2022","Midfielder","Leicester City",60,0,60,"England",1,0,1,0,0,0,0,0,0,0,0,0,0,0,0,0,0,0,0,-1,-1,-1
"301","Harry Kane",5,27,"1993","07","27","2017/2018","Forward","Tottenham Hotspur",3083,1690,1393,"England",37,19,18,30,15,15,2,2,0,2,1,16,10,6,30,15,15,5,0,3,185,-1
"302","Harry Kane",5,27,"1993","07","28","2018/2019","Forward","Tottenham Hotspur",2427,1066,1361,"England",28,12,16,17,6,11,4,2,2,4,0,10,4,6,28,10,18,5,0,5,94,-1
"303","Harry Kane",5,27,"1993","07","28","2019/2020","Forward","Tottenham Hotspur",2590,1345,1245,"England",29,15,14,18,9,9,2,2,0,2,0,6,5,1,34,11,23,4,0,8,169,-1
"304","Harry Kane",5,28,"1993","07","28","2020/2021","Forward","Tottenham Hotspur",3087,1473,1614,"England",35,17,18,23,11,12,14,7,7,4,0,12,7,5,35,13,22,1,0,4,5,-1
"305","Harry Kane",5,28,"1993","07","28","2021/2022","Forward","Tottenham Hotspur",918,450,468,"England",11,5,6,1,0,1,1,0,1,0,0,3,1,2,15,7,8,2,0,121,114,-1
"306","Harry Maguire",5,28,"1993","03","05","2017/2018","Defender","Leicester City",3420,1710,1710,"England",38,19,19,2,2,0,4,1,3,0,0,9,6,3,57,21,36,7,0,223,117,133
"307","Harry Maguire",5,28,"1993","03","05","2018/2019","Defender","Leicester City",2599,1350,1249,"England",31,15,16,3,0,3,0,0,0,0,0,7,3,4,36,16,20,7,1,165,299,78
"308","Harry Maguire",5,28,"1993","03","05","2019/2020","Defender","Manchester United",3420,1710,1710,"England",38,19,19,1,0,1,1,1,0,0,0,13,7,6,32,15,17,6,0,245,238,20
"309","Harry Maguire",5,28,"1993","03","05","2020/2021","Defender","Manchester United",3048,1440,1608,"England",34,16,18,2,1,1,1,1,0,0,0,13,6,7,34,20,14,11,0,199,224,37
"310","Harry Maguire",5,28,"1993","03","05","2021/2022","Defender","Manchester United",945,426,519,"England",11,5,6,0,0,0,0,0,0,0,0,2,0,2,16,9,7,5,1,244,250,85
"311","Harry Winks",5,25,"1996","02","02","2017/2018","Midfielder","Tottenham Hotspur",771,440,331,"England",16,8,8,0,0,0,1,1,0,0,0,6,3,3,7,2,5,0,0,373,108,-1
"312","Harry Winks",5,25,"1996","02","02","2018/2019","Midfielder","Tottenham Hotspur",1591,832,759,"England",26,13,13,1,0,1,0,0,0,0,0,10,4,6,16,8,8,4,0,207,335,-1
"313","Harry Winks",5,25,"1996","02","02","2019/2020","Midfielder","Tottenham Hotspur",2226,1183,1043,"England",31,17,14,0,0,0,0,0,0,0,0,7,5,2,29,12,17,9,0,415,392,-1
"314","Harry Winks",5,25,"1996","02","02","2020/2021","Midfielder","Tottenham Hotspur",860,590,270,"England",15,12,3,0,0,0,0,0,0,0,0,3,3,0,13,9,4,5,0,396,394,-1
"315","Harry Winks",5,25,"1996","02","02","2021/2022","Midfielder","Tottenham Hotspur",150,90,60,"England",3,1,2,0,0,0,0,0,0,0,0,1,0,1,1,1,0,0,0,-1,-1,-1
"316","Harvey Lewis Barnes",5,23,"1997","12","09","2017/2018","Midfielder","Leicester City",7,2,5,"England",3,2,1,0,0,0,0,0,0,0,0,1,1,0,0,0,0,0,0,-1,-1,-1
"317","Harvey Lewis Barnes",5,23,"1997","12","09","2018/2019","Midfielder","Leicester City",1007,601,406,"England",16,9,7,1,0,1,2,2,0,0,0,3,3,0,16,7,9,0,0,175,78,-1
"318","Harvey Lewis Barnes",5,23,"1997","12","09","2019/2020","Midfielder","Leicester City",2091,1151,940,"England",36,19,17,6,4,2,8,6,2,0,0,12,8,4,23,10,13,0,0,68,15,-1
"319","Harvey Lewis Barnes",5,23,"1997","12","09","2020/2021","Midfielder","Leicester City",1949,951,998,"England",25,13,12,9,6,3,4,2,2,0,0,9,4,5,24,15,9,0,0,30,65,-1
"320","Harvey Lewis Barnes",5,23,"1997","12","09","2021/2022","Midfielder","Leicester City",796,415,381,"England",11,6,5,1,0,1,1,0,1,0,0,1,1,0,15,7,8,2,0,111,105,-1
"321","Hector Bellerin",5,26,"1995","03","19","2017/2018","Defender","Arsenal",3051,1604,1447,"Spain",35,18,17,2,1,1,3,3,0,0,0,12,8,4,41,20,21,5,0,201,153,68
"322","Hector Bellerin",5,26,"1995","03","19","2018/2019","Defender","Arsenal",1535,882,653,"Spain",19,10,9,0,0,0,5,4,1,0,0,4,4,0,20,8,12,3,0,385,26,61
"323","Hector Bellerin",5,26,"1995","03","19","2019/2020","Defender","Arsenal",1159,521,638,"Spain",15,7,8,1,0,1,0,0,0,0,0,6,3,3,16,7,9,2,0,176,327,72
"324","Hector Bellerin",5,26,"1995","03","19","2020/2021","Defender","Arsenal",2093,1042,1051,"Spain",25,12,13,1,1,0,2,2,0,0,0,9,2,7,24,14,10,8,0,244,143,40
"325","Hector Bellerin",5,26,"1995","03","19","2021/2022","Defender","Arsenal",0,0,0,"Spain",0,0,0,0,0,0,0,0,0,0,0,0,0,0,0,0,0,0,0,-1,-1,-1
"326","Heung-Min Son",5,28,"1992","07","07","2017/2018","Forward","Tottenham Hotspur",2311,1325,986,"South Korea",37,19,18,12,9,3,6,5,1,0,0,16,10,6,16,7,9,0,0,23,48,-1
"327","Heung-Min Son",5,28,"1992","07","08","2018/2019","Forward","Tottenham Hotspur",2048,1161,887,"South Korea",31,16,15,12,8,4,6,2,4,0,0,11,7,4,20,8,12,3,1,14,34,-1
"328","Heung-Min Son",5,28,"1992","07","08","2019/2020","Forward","Tottenham Hotspur",2485,1321,1164,"South Korea",30,16,14,11,7,4,10,6,4,0,1,8,6,2,30,10,20,2,2,37,13,-1
"329","Heung-Min Son",5,29,"1992","07","08","2020/2021","Forward","Tottenham Hotspur",3126,1649,1477,"South Korea",37,19,18,17,8,9,10,7,3,1,0,11,7,4,34,15,19,0,0,21,12,-1
"330","Heung-Min Son",5,29,"1992","07","08","2021/2022","Forward","Tottenham Hotspur",965,538,427,"South Korea",11,6,5,4,2,2,1,1,0,0,0,4,2,2,13,7,6,0,0,32,117,-1
"331","Hugo Lloris",5,34,"1986","12","26","2017/2018","Goalkeeper","Tottenham Hotspur",3240,1620,1620,"France",36,18,18,0,0,0,0,0,0,0,0,15,9,6,31,15,16,1,0,368,341,33
"332","Hugo Lloris",5,34,"1986","12","26","2018/2019","Goalkeeper","Tottenham Hotspur",2970,1620,1350,"France",33,18,15,0,0,0,0,0,0,0,0,12,7,5,30,13,17,0,0,339,284,21
"333","Hugo Lloris",5,34,"1986","12","26","2019/2020","Goalkeeper","Tottenham Hotspur",1808,990,818,"France",21,11,10,0,0,0,0,0,0,0,0,6,5,1,21,6,15,0,0,411,410,47
"334","Hugo Lloris",5,34,"1986","12","26","2020/2021","Goalkeeper","Tottenham Hotspur",3420,1710,1710,"France",38,19,19,0,0,0,0,0,0,0,0,12,7,5,40,17,23,0,0,364,390,41
"335","Hugo Lloris",5,34,"1986","12","26","2021/2022","Goalkeeper","Tottenham Hotspur",1080,540,540,"France",12,6,6,0,0,0,0,0,0,0,0,4,2,2,15,7,8,0,0,183,196,63
"336","İlkay Gündoğan",5,30,"1990","10","23","2017/2018","Midfielder","Manchester City",1508,735,773,"Germany",30,13,17,4,2,2,1,1,0,1,0,15,6,9,13,6,7,3,0,72,182,-1
"337","İlkay Gündoğan",5,30,"1990","10","24","2018/2019","Midfielder","Manchester City",2135,985,1150,"Germany",31,15,16,6,4,2,3,0,3,0,0,15,6,9,15,8,7,3,0,78,120,-1
"338","İlkay Gündoğan",5,30,"1990","10","24","2019/2020","Midfielder","Manchester City",2015,1057,958,"Germany",31,17,14,2,2,0,1,1,0,1,1,12,8,4,24,7,17,7,0,172,232,-1
"339","İlkay Gündoğan",5,31,"1990","10","24","2020/2021","Midfielder","Manchester City",2031,1213,818,"Germany",28,17,11,13,7,6,2,0,2,1,1,14,9,5,14,7,7,1,0,10,152,-1
"340","İlkay Gündoğan",5,31,"1990","10","24","2021/2022","Midfielder","Manchester City",774,429,345,"Germany",9,5,4,3,2,1,1,1,0,0,0,6,4,2,1,0,1,1,0,34,100,-1
"341","Isaac Hayden",5,26,"1995","03","22","2017/2018","Midfielder","Newcastle United",1370,612,758,"England",26,11,15,1,0,1,0,0,0,0,0,8,6,2,24,6,18,7,0,188,334,-1
"342","Isaac Hayden",5,26,"1995","03","22","2018/2019","Midfielder","Newcastle United",1886,904,982,"England",25,11,14,1,0,1,4,4,0,0,0,7,3,4,25,12,13,4,1,219,67,-1
"343","Isaac Hayden",5,26,"1995","03","22","2019/2020","Midfielder","Newcastle United",2226,1260,966,"England",29,16,13,1,1,0,2,2,0,0,0,9,6,3,28,14,14,5,1,225,156,-1
"344","Isaac Hayden",5,26,"1995","03","22","2020/2021","Midfielder","Newcastle United",1943,998,945,"England",24,13,11,0,0,0,0,0,0,0,0,4,1,3,32,16,16,8,0,324,314,-1
"345","Isaac Hayden",5,26,"1995","03","22","2021/2022","Midfielder","Newcastle United",852,354,498,"England",12,5,7,1,0,1,0,0,0,0,0,0,0,0,19,10,9,3,0,113,155,-1
"346","Jack Cork",5,31,"1989","06","24","2017/2018","Midfielder","Burnley",3420,1710,1710,"England",38,19,19,2,1,1,1,0,1,0,0,12,7,5,34,13,21,7,0,215,232,-1
"347","Jack Cork",5,31,"1989","06","25","2018/2019","Midfielder","Burnley",3313,1693,1620,"England",37,19,18,1,1,0,2,1,1,0,0,8,5,3,54,27,27,6,0,249,204,-1
"348","Jack Cork",5,31,"1989","06","25","2019/2020","Midfielder","Burnley",2618,1346,1272,"England",30,15,15,0,0,0,0,0,0,0,0,12,7,5,40,18,22,1,0,319,414,-1
"349","Jack Cork",5,32,"1989","06","25","2020/2021","Midfielder","Burnley",1352,731,621,"England",16,9,7,0,0,0,0,0,0,0,0,4,1,3,23,14,9,2,0,287,294,-1
"350","Jack Cork",5,32,"1989","06","25","2021/2022","Midfielder","Burnley",317,85,232,"England",4,1,3,0,0,0,0,0,0,0,0,0,0,0,8,2,6,1,0,230,212,-1
"351","Jack Stephens",5,27,"1994","01","27","2017/2018","Defender","Southampton",1980,990,990,"England",22,11,11,2,1,1,0,0,0,0,0,5,2,3,31,12,19,7,1,162,405,109
"352","Jack Stephens",5,27,"1994","01","27","2018/2019","Defender","Southampton",1697,816,881,"England",24,10,14,1,1,0,0,0,0,0,0,5,2,3,30,11,19,4,0,223,369,130
"353","Jack Stephens",5,27,"1994","01","27","2019/2020","Defender","Southampton",2452,1209,1243,"England",28,14,14,1,0,1,3,1,2,0,0,7,3,4,35,17,18,5,1,240,129,85
"354","Jack Stephens",5,27,"1994","01","27","2020/2021","Defender","Southampton",1538,900,638,"England",18,10,8,0,0,0,0,0,0,0,0,4,3,1,32,13,19,2,0,356,346,150
"355","Jack Stephens",5,27,"1994","01","27","2021/2022","Defender","Southampton",397,180,217,"England",5,2,3,0,0,0,0,0,0,0,0,2,1,1,5,1,4,2,0,296,296,54
"356","Jaïro Riedewald",5,24,"1996","09","08","2017/2018","Defender","Crystal Palace",434,384,50,"Netherlands",12,7,5,0,0,0,0,0,0,0,0,3,2,1,5,4,1,0,0,395,358,57
"357","Jaïro Riedewald",5,24,"1996","09","09","2018/2019","Defender","Crystal Palace",0,0,0,"Netherlands",0,0,0,0,0,0,0,0,0,0,0,0,0,0,0,0,0,0,0,-1,-1,-1
"358","Jaïro Riedewald",5,24,"1996","09","09","2019/2020","Defender","Crystal Palace",763,279,484,"Netherlands",17,7,10,0,0,0,0,0,0,0,0,4,1,3,9,3,6,0,0,302,261,48
"359","Jaïro Riedewald",5,25,"1996","09","09","2020/2021","Defender","Crystal Palace",1816,784,1032,"Netherlands",33,17,16,2,0,2,0,0,0,0,0,6,5,1,35,12,23,4,0,151,275,142
"360","Jaïro Riedewald",5,25,"1996","09","09","2021/2022","Defender","Crystal Palace",101,0,101,"Netherlands",2,0,2,0,0,0,0,0,0,0,0,0,0,0,5,0,5,0,0,-1,-1,-1
"361","Jamal Lascelles",5,27,"1993","11","11","2017/2018","Defender","Newcastle United",2928,1488,1440,"England",33,17,16,3,2,1,0,0,0,0,0,9,7,2,31,10,21,5,0,159,337,47
"362","Jamal Lascelles",5,27,"1993","11","11","2018/2019","Defender","Newcastle United",2748,1308,1440,"England",32,16,16,0,0,0,1,1,0,0,0,11,5,6,33,16,17,4,0,346,245,41
"363","Jamal Lascelles",5,27,"1993","11","11","2019/2020","Defender","Newcastle United",2079,1010,1069,"England",24,12,12,1,1,0,0,0,0,0,0,8,6,2,26,7,19,5,0,229,276,54
"364","Jamal Lascelles",5,27,"1993","11","11","2020/2021","Defender","Newcastle United",1628,676,952,"England",19,8,11,2,2,0,0,0,0,0,0,3,0,3,29,12,17,4,0,143,313,128
"365","Jamal Lascelles",5,27,"1993","11","11","2021/2022","Defender","Newcastle United",900,450,450,"England",10,5,5,1,1,0,0,0,0,0,0,0,0,0,20,11,9,5,0,119,159,120
"366","James McArthur",5,33,"1987","10","06","2017/2018","Midfielder","Crystal Palace",2434,1131,1303,"Scotland",33,16,17,5,3,2,1,1,0,0,0,8,3,5,34,16,18,5,0,103,222,-1
"367","James McArthur",5,33,"1987","10","07","2018/2019","Midfielder","Crystal Palace",3071,1506,1565,"Scotland",38,19,19,3,1,2,6,1,5,0,0,12,7,5,44,19,25,7,0,179,74,-1
"368","James McArthur",5,33,"1987","10","07","2019/2020","Midfielder","Crystal Palace",3105,1607,1498,"Scotland",37,19,18,0,0,0,3,2,1,0,0,10,6,4,38,17,21,6,0,334,154,-1
"369","James McArthur",5,34,"1987","10","07","2020/2021","Midfielder","Crystal Palace",1471,801,670,"Scotland",18,10,8,0,0,0,2,1,1,0,0,3,2,1,25,13,12,3,0,351,117,-1
"370","James McArthur",5,34,"1987","10","07","2021/2022","Midfielder","Crystal Palace",953,530,423,"Scotland",11,6,5,0,0,0,1,1,0,0,0,4,3,1,10,3,7,3,0,224,125,-1
"371","James Milner",5,35,"1986","01","04","2017/2018","Midfielder","Liverpool",1762,866,896,"England",32,16,16,0,0,0,3,2,1,0,0,13,9,4,22,6,16,3,0,348,85,-1
"372","James Milner",5,35,"1986","01","04","2018/2019","Midfielder","Liverpool",1785,646,1139,"England",31,12,19,5,0,5,4,2,2,3,0,18,9,9,11,4,7,7,1,81,65,-1
"373","James Milner",5,35,"1986","01","04","2019/2020","Midfielder","Liverpool",926,560,366,"England",22,12,10,2,1,1,2,1,1,2,0,8,3,5,9,7,2,4,0,94,61,-1
"374","James Milner",5,35,"1986","01","04","2020/2021","Midfielder","Liverpool",1061,441,620,"England",26,12,14,0,0,0,1,1,0,0,0,9,3,6,9,6,3,3,0,362,154,-1
"375","James Milner",5,35,"1986","01","04","2021/2022","Midfielder","Liverpool",391,191,200,"England",6,3,3,0,0,0,1,0,1,0,0,5,2,3,1,1,0,2,0,262,50,-1
"376","James Tarkowski",5,28,"1992","11","19","2017/2018","Defender","Burnley",2790,1440,1350,"England",31,16,15,0,0,0,0,0,0,0,0,11,7,4,27,9,18,5,0,325,276,35
"377","James Tarkowski",5,28,"1992","11","19","2018/2019","Defender","Burnley",3087,1620,1467,"England",35,18,17,3,2,1,1,1,0,0,0,7,5,2,52,25,27,8,0,170,238,121
"378","James Tarkowski",5,28,"1992","11","19","2019/2020","Defender","Burnley",3420,1710,1710,"England",38,19,19,2,1,1,2,1,1,0,0,15,8,7,48,22,26,10,0,220,214,79
"379","James Tarkowski",5,28,"1992","11","19","2020/2021","Defender","Burnley",3240,1620,1620,"England",36,18,18,1,0,1,0,0,0,0,0,11,3,8,49,26,23,6,0,261,286,101
"380","James Tarkowski",5,28,"1992","11","19","2021/2022","Defender","Burnley",1080,540,540,"England",12,6,6,1,1,0,2,2,0,0,0,1,1,0,20,8,12,5,0,140,76,96
"381","James Tomkins",5,31,"1989","03","28","2017/2018","Defender","Crystal Palace",2388,1218,1170,"England",28,15,13,3,2,1,0,0,0,0,0,8,4,4,30,14,16,8,0,143,352,62
"382","James Tomkins",5,32,"1989","03","29","2018/2019","Defender","Crystal Palace",2563,1140,1423,"England",29,13,16,1,0,1,1,0,1,0,0,10,5,5,34,12,22,6,0,235,215,63
"383","James Tomkins",5,32,"1989","03","29","2019/2020","Defender","Crystal Palace",1584,803,781,"England",18,9,9,1,0,1,1,1,0,0,0,3,1,2,23,12,11,5,0,216,190,93
"384","James Tomkins",5,32,"1989","03","29","2020/2021","Defender","Crystal Palace",552,314,238,"England",8,5,3,0,0,0,0,0,0,0,0,2,1,1,10,5,5,1,0,292,263,134
"385","James Tomkins",5,32,"1989","03","29","2021/2022","Defender","Crystal Palace",188,90,98,"England",3,1,2,0,0,0,0,0,0,0,0,0,0,0,2,2,0,0,0,-1,-1,-1
"386","James Ward-Prowse",5,26,"1994","11","01","2017/2018","Midfielder","Southampton",1716,855,861,"England",30,16,14,3,0,3,3,2,1,0,0,5,1,4,26,13,13,3,0,112,78,-1
"387","James Ward-Prowse",5,26,"1994","11","01","2018/2019","Midfielder","Southampton",1942,942,1000,"England",26,13,13,7,5,2,0,0,0,1,0,4,2,2,36,15,21,4,0,58,347,-1
"388","James Ward-Prowse",5,26,"1994","11","01","2019/2020","Midfielder","Southampton",3420,1710,1710,"England",38,19,19,5,2,3,3,1,2,1,2,9,3,6,56,33,23,9,0,129,166,-1
"389","James Ward-Prowse",5,27,"1994","11","01","2020/2021","Midfielder","Southampton",3420,1710,1710,"England",38,19,19,8,3,5,7,4,3,3,1,9,6,3,59,23,36,5,0,82,70,-1
"390","James Ward-Prowse",5,27,"1994","11","01","2021/2022","Midfielder","Southampton",967,360,607,"England",11,4,7,2,0,2,0,0,0,2,0,4,2,2,13,2,11,3,1,77,301,-1
"391","Jamie Vardy",5,34,"1987","01","11","2017/2018","Forward","Leicester City",3258,1612,1646,"England",37,18,19,20,9,11,1,0,1,5,1,8,5,3,55,21,34,3,0,16,241,-1
"392","Jamie Vardy",5,34,"1987","01","11","2018/2019","Forward","Leicester City",2735,1418,1317,"England",34,17,17,18,8,10,4,3,1,4,1,10,6,4,33,13,20,4,1,9,118,-1
"393","Jamie Vardy",5,34,"1987","01","11","2019/2020","Forward","Leicester City",3034,1594,1440,"England",35,19,16,23,12,11,5,4,1,4,1,12,8,4,35,15,20,2,0,6,89,-1
"394","Jamie Vardy",5,34,"1987","01","11","2020/2021","Forward","Leicester City",2845,1523,1322,"England",34,17,17,15,6,9,9,7,2,8,1,10,6,4,43,25,18,1,0,26,17,-1
"395","Jamie Vardy",5,34,"1987","01","11","2021/2022","Forward","Leicester City",1117,630,487,"England",13,7,6,9,6,3,1,0,1,0,0,1,1,0,21,12,9,2,0,5,138,-1
"396","Jan Bednarek",5,24,"1996","04","11","2017/2018","Defender","Southampton",428,180,248,"Poland",5,2,3,1,1,0,0,0,0,0,0,2,0,2,4,4,0,1,0,85,394,28
"397","Jan Bednarek",5,24,"1996","04","12","2018/2019","Defender","Southampton",2151,1126,1025,"Poland",25,13,12,0,0,0,1,0,1,0,0,3,1,2,33,19,14,7,0,377,225,98
"398","Jan Bednarek",5,25,"1996","04","12","2019/2020","Defender","Southampton",3058,1530,1528,"Poland",34,17,17,1,1,0,1,0,1,0,0,7,3,4,53,30,23,4,0,247,240,126
"399","Jan Bednarek",5,25,"1996","04","12","2020/2021","Defender","Southampton",3104,1486,1618,"Poland",36,17,19,1,1,0,1,1,0,0,0,9,6,3,55,21,34,6,1,253,241,126
"400","Jan Bednarek",5,25,"1996","04","12","2021/2022","Defender","Southampton",810,404,406,"Poland",10,5,5,0,0,0,0,0,0,0,0,4,2,2,12,4,8,3,0,305,306,74
"401","Javier Manquillo Gaitán",5,26,"1994","05","04","2017/2018","Defender","Newcastle United",1759,810,949,"Spain",21,9,12,0,0,0,1,0,1,0,0,4,2,2,30,11,19,2,0,365,193,143
"402","Javier Manquillo Gaitán",5,26,"1994","05","05","2018/2019","Defender","Newcastle United",1097,503,594,"Spain",18,9,9,0,0,0,3,2,1,0,0,6,3,3,12,6,6,2,0,350,40,30
"403","Javier Manquillo Gaitán",5,26,"1994","05","05","2019/2020","Defender","Newcastle United",1599,957,642,"Spain",21,12,9,0,0,0,1,0,1,0,0,7,4,3,20,12,8,5,0,377,201,53
"404","Javier Manquillo Gaitán",5,27,"1994","05","05","2020/2021","Defender","Newcastle United",826,305,521,"Spain",13,7,6,0,0,0,0,0,0,0,0,3,0,3,14,8,6,1,0,322,302,118
"405","Javier Manquillo Gaitán",5,27,"1994","05","05","2021/2022","Defender","Newcastle United",678,351,327,"Spain",8,4,4,1,0,1,2,1,1,0,0,0,0,0,14,8,6,2,0,104,28,111
"406","Jeff Hendrick",5,29,"1992","01","31","2017/2018","Midfielder","Burnley",2342,1164,1178,"Republic of Ireland",34,17,17,2,1,1,2,2,0,0,0,11,6,5,24,9,15,1,0,176,158,-1
"407","Jeff Hendrick",5,29,"1992","01","31","2018/2019","Midfielder","Burnley",2069,898,1171,"Republic of Ireland",32,15,17,3,1,2,0,0,0,0,0,6,3,3,41,18,23,4,0,131,349,-1
"408","Jeff Hendrick",5,29,"1992","01","31","2019/2020","Midfielder","Burnley",1935,1042,893,"Republic of Ireland",24,12,12,2,1,1,2,1,1,0,0,10,6,4,29,13,16,8,0,167,151,-1
"409","Jeff Hendrick",5,29,"1992","01","31","2020/2021","Midfielder","Newcastle United",1423,560,863,"Republic of Ireland",22,7,15,2,0,2,1,0,1,0,0,5,0,5,22,12,10,3,1,126,194,-1
"410","Jeff Hendrick",5,29,"1992","01","31","2021/2022","Midfielder","Newcastle United",60,0,60,"Republic of Ireland",2,0,2,1,0,1,0,0,0,0,0,0,0,0,1,0,1,0,0,-1,-1,-1
"411","Jeffrey Schlupp",5,28,"1992","12","23","2017/2018","Defender","Crystal Palace",1748,792,956,"Ghana",24,10,14,0,0,0,1,1,0,0,0,5,1,4,30,15,15,3,0,386,207,144
"412","Jeffrey Schlupp",5,28,"1992","12","23","2018/2019","Defender","Crystal Palace",1665,849,816,"Ghana",30,14,16,4,1,3,1,1,0,0,0,8,4,4,24,11,13,1,0,89,209,86
"413","Jeffrey Schlupp",5,28,"1992","12","23","2019/2020","Defender","Crystal Palace",1035,591,444,"Ghana",17,9,8,3,2,1,1,0,1,0,0,5,3,2,15,7,8,2,0,66,146,90
"414","Jeffrey Schlupp",5,28,"1992","12","23","2020/2021","Defender","Crystal Palace",1425,845,580,"Ghana",27,14,13,2,2,0,3,1,2,0,0,5,4,1,23,14,9,3,0,125,62,110
"415","Jeffrey Schlupp",5,28,"1992","12","23","2021/2022","Defender","Crystal Palace",283,118,165,"Ghana",10,5,5,1,1,0,0,0,0,0,0,3,2,1,2,0,2,0,0,40,231,20
"416","Jesse Lingard",5,28,"1992","12","15","2017/2018","Midfielder","Manchester United",1821,731,1090,"England",33,16,17,8,3,5,5,2,3,0,0,15,10,5,18,4,14,2,0,31,33,-1
"417","Jesse Lingard",5,28,"1992","12","15","2018/2019","Midfielder","Manchester United",1668,963,705,"England",27,15,12,4,1,3,2,1,1,1,0,6,2,4,25,16,9,3,0,87,135,-1
"418","Jesse Lingard",5,28,"1992","12","15","2019/2020","Midfielder","Manchester United",931,454,477,"England",22,10,12,1,0,1,0,0,0,0,0,5,2,3,13,4,9,3,0,155,353,-1
"419","Jesse Lingard",5,28,"1992","12","15","2020/2021","Midfielder","West Ham United",1426,709,717,"England",16,8,8,9,5,4,4,1,3,1,1,4,3,1,18,7,11,3,0,11,26,-1
"420","Jesse Lingard",5,28,"1992","12","15","2021/2022","Midfielder","Manchester United",76,24,52,"England",7,1,6,2,1,1,0,0,0,0,0,1,0,1,1,0,1,0,0,-1,-1,-1
"421","Joe Gomez",5,23,"1997","05","22","2017/2018","Defender","Liverpool",1900,910,990,"England",23,11,12,0,0,0,2,2,0,0,0,10,7,3,20,5,15,3,0,349,151,48
"422","Joe Gomez",5,23,"1997","05","23","2018/2019","Defender","Liverpool",1060,493,567,"England",16,8,8,0,0,0,0,0,0,0,0,11,8,3,3,0,3,2,0,407,398,1
"423","Joe Gomez",5,23,"1997","05","23","2019/2020","Defender","Liverpool",1999,1095,904,"England",28,15,13,0,0,0,0,0,0,0,0,13,7,6,16,8,8,7,0,342,313,7
"424","Joe Gomez",5,24,"1997","05","23","2020/2021","Defender","Liverpool",590,360,230,"England",7,4,3,0,0,0,0,0,0,0,0,0,0,0,14,6,8,0,0,359,352,154
"425","Joe Gomez",5,24,"1997","05","23","2021/2022","Defender","Liverpool",12,12,0,"England",2,2,0,0,0,0,0,0,0,0,0,1,1,0,1,1,0,0,0,-1,-1,-1
"426","Joel Matip",5,29,"1991","08","07","2017/2018","Defender","Liverpool",1994,1004,990,"Cameroon",25,13,12,1,0,1,0,0,0,0,0,10,7,3,23,7,16,3,0,217,305,55
"427","Joel Matip",5,29,"1991","08","08","2018/2019","Defender","Liverpool",1532,811,721,"Cameroon",22,10,12,1,1,0,0,0,0,0,0,11,6,5,9,5,4,3,0,215,286,8
"428","Joel Matip",5,29,"1991","08","08","2019/2020","Defender","Liverpool",703,180,523,"Cameroon",9,3,6,1,1,0,0,0,0,0,0,3,0,3,5,2,3,0,0,122,299,5
"429","Joel Matip",5,30,"1991","08","08","2020/2021","Defender","Liverpool",693,331,362,"Cameroon",10,5,5,1,1,0,2,1,1,0,0,3,2,1,5,1,4,2,0,133,23,7
"430","Joel Matip",5,30,"1991","08","08","2021/2022","Defender","Liverpool",810,360,450,"Cameroon",9,4,5,0,0,0,0,0,0,0,0,5,2,3,9,3,6,0,0,288,266,45
"431","Joel Ward",5,31,"1989","10","28","2017/2018","Defender","Crystal Palace",1616,780,836,"England",19,9,10,0,0,0,1,1,0,0,0,4,1,3,25,14,11,4,0,394,177,107
"432","Joel Ward",5,31,"1989","10","29","2018/2019","Defender","Crystal Palace",551,191,360,"England",7,3,4,1,1,0,0,0,0,0,0,0,0,0,12,6,6,1,0,114,358,159
"433","Joel Ward",5,31,"1989","10","29","2019/2020","Defender","Crystal Palace",2383,1268,1115,"England",29,15,14,0,0,0,0,0,0,0,0,7,5,2,34,13,21,4,0,333,351,84
"434","Joel Ward",5,32,"1989","10","29","2020/2021","Defender","Crystal Palace",2255,1085,1170,"England",26,13,13,0,0,0,1,0,1,0,0,8,6,2,40,14,26,5,0,340,212,129
"435","Joel Ward",5,32,"1989","10","29","2021/2022","Defender","Crystal Palace",1260,630,630,"England",14,7,7,0,0,0,0,0,0,0,0,4,3,1,17,5,12,5,0,222,230,57
"436","Johann Berg Guðmunds­son",5,30,"1990","10","26","2017/2018","Midfielder","Burnley",2839,1566,1273,"Iceland",35,19,16,2,2,0,8,6,2,0,0,11,7,4,29,12,17,2,0,204,31,-1
"437","Johann Berg Guðmunds­son",5,30,"1990","10","27","2018/2019","Midfielder","Burnley",1748,847,901,"Iceland",29,15,14,3,0,3,6,5,1,0,0,6,4,2,31,13,18,2,0,122,18,-1
"438","Johann Berg Guðmunds­son",5,30,"1990","10","27","2019/2020","Midfielder","Burnley",620,375,245,"Iceland",12,7,5,1,1,0,1,0,1,0,0,3,2,1,6,3,3,0,0,109,91,-1
"439","Johann Berg Guðmunds­son",5,31,"1990","10","27","2020/2021","Midfielder","Burnley",1368,774,594,"Iceland",22,12,10,2,1,1,0,0,0,0,0,4,1,3,24,14,10,2,0,134,288,-1
"440","Johann Berg Guðmunds­son",5,31,"1990","10","27","2021/2022","Midfielder","Burnley",720,420,300,"Iceland",12,6,6,0,0,0,1,0,1,0,0,1,1,0,14,7,7,2,0,205,92,-1
"441","John Stones",5,26,"1994","05","27","2017/2018","Defender","Manchester City",1305,734,571,"England",18,10,8,0,0,0,0,0,0,0,0,9,4,5,10,5,5,0,0,360,356,13
"442","John Stones",5,26,"1994","05","28","2018/2019","Defender","Manchester City",1762,968,794,"England",24,12,12,0,0,0,0,0,0,0,0,13,6,7,15,8,7,1,0,309,418,17
"443","John Stones",5,26,"1994","05","28","2019/2020","Defender","Manchester City",1119,624,495,"England",16,8,8,0,0,0,0,0,0,0,0,7,3,4,14,6,8,0,0,358,284,56
"444","John Stones",5,27,"1994","05","28","2020/2021","Defender","Manchester City",1934,990,944,"England",22,11,11,4,3,1,0,0,0,0,0,14,8,6,10,4,6,1,1,89,244,1
"445","John Stones",5,27,"1994","05","28","2021/2022","Defender","Manchester City",301,211,90,"England",4,3,1,0,0,0,0,0,0,0,0,3,2,1,1,1,0,0,0,201,173,4
"446","Jonjo Shelvey",5,29,"1992","02","27","2017/2018","Midfielder","Newcastle United",2268,1238,1030,"England",30,16,14,1,0,1,3,3,0,0,0,7,6,1,27,9,18,5,2,224,113,-1
"447","Jonjo Shelvey",5,29,"1992","02","27","2018/2019","Midfielder","Newcastle United",944,403,541,"England",16,8,8,1,0,1,1,0,1,0,0,5,1,4,11,8,3,1,0,167,149,-1
"448","Jonjo Shelvey",5,29,"1992","02","27","2019/2020","Midfielder","Newcastle United",2124,1248,876,"England",26,16,10,6,3,3,2,1,1,0,0,8,5,3,31,16,15,3,0,71,160,-1
"449","Jonjo Shelvey",5,29,"1992","02","27","2020/2021","Midfielder","Newcastle United",2617,1357,1260,"England",30,16,14,1,1,0,3,1,2,0,0,6,1,5,44,26,18,7,0,254,139,-1
"450","Jonjo Shelvey",5,29,"1992","02","27","2021/2022","Midfielder","Newcastle United",467,289,178,"England",7,5,2,0,0,0,0,0,0,0,0,0,0,0,11,8,3,4,1,154,151,-1
"451","Jonny Evans",5,33,"1988","01","03","2017/2018","Defender","West Bromwich Albion",2272,1093,1179,"Northern Ireland",28,13,15,2,2,0,2,2,0,0,0,6,4,2,35,18,17,7,0,179,156,105
"452","Jonny Evans",5,33,"1988","01","03","2018/2019","Defender","Leicester City",1995,1074,921,"Northern Ireland",24,12,12,1,1,0,0,0,0,0,0,8,6,2,22,9,13,2,0,224,319,32
"453","Jonny Evans",5,33,"1988","01","03","2019/2020","Defender","Leicester City",3386,1710,1676,"Northern Ireland",38,19,19,1,0,1,1,1,0,0,0,13,8,5,38,16,22,9,1,255,242,42
"454","Jonny Evans",5,33,"1988","01","03","2020/2021","Defender","Leicester City",2476,1329,1147,"Northern Ireland",28,15,13,2,1,1,2,1,1,0,0,10,6,4,30,17,13,7,0,190,170,49
"455","Jonny Evans",5,33,"1988","01","03","2021/2022","Defender","Leicester City",567,387,180,"Northern Ireland",7,5,2,0,0,0,1,1,0,0,0,0,0,0,12,10,2,2,0,171,79,115
"456","Jordan Ayew",5,29,"1991","09","10","2017/2018","Forward","Swansea City",2859,1558,1301,"Ghana",36,19,17,7,4,3,2,2,0,1,0,9,5,4,46,22,24,3,1,80,190,-1
"457","Jordan Ayew",5,29,"1991","09","11","2018/2019","Forward","Crystal Palace",1186,616,570,"Ghana",20,8,12,1,0,1,2,0,2,0,0,6,3,3,13,7,6,3,0,187,96,-1
"458","Jordan Ayew",5,29,"1991","09","11","2019/2020","Forward","Crystal Palace",3162,1624,1538,"Ghana",37,19,18,9,4,5,2,2,0,0,0,10,6,4,44,17,27,6,0,65,197,-1
"459","Jordan Ayew",5,30,"1991","09","11","2020/2021","Forward","Crystal Palace",2097,1017,1080,"Ghana",33,16,17,1,1,0,3,2,1,0,0,8,6,2,40,16,24,4,0,233,106,-1
"460","Jordan Ayew",5,30,"1991","09","11","2021/2022","Forward","Crystal Palace",805,251,554,"Ghana",13,6,7,0,0,0,1,0,1,0,0,4,3,1,14,2,12,1,0,226,108,-1
"461","Jordan Henderson",5,30,"1990","06","16","2017/2018","Midfielder","Liverpool",2173,1145,1028,"England",27,13,14,1,0,1,1,0,1,0,0,14,10,4,19,2,17,1,0,228,214,-1
"462","Jordan Henderson",5,30,"1990","06","17","2018/2019","Midfielder","Liverpool",1983,925,1058,"England",32,16,16,1,0,1,3,2,1,0,0,19,10,9,11,4,7,3,1,217,102,-1
"463","Jordan Henderson",5,30,"1990","06","17","2019/2020","Midfielder","Liverpool",2244,992,1252,"England",30,14,16,4,2,2,5,2,3,0,0,15,7,8,14,5,9,2,0,107,56,-1
"464","Jordan Henderson",5,31,"1990","06","17","2020/2021","Midfielder","Liverpool",1707,807,900,"England",21,10,11,1,0,1,1,1,0,0,0,5,2,3,22,12,10,0,0,222,198,-1
"465","Jordan Henderson",5,31,"1990","06","17","2021/2022","Midfielder","Liverpool",900,513,387,"England",12,7,5,1,1,0,2,0,2,0,0,7,4,3,11,5,6,1,0,122,58,-1
"466","Jordan Pickford",5,27,"1994","03","07","2017/2018","Goalkeeper","Everton",3420,1710,1710,"England",38,19,19,0,0,0,0,0,0,0,0,10,7,3,55,20,35,0,0,304,268,120
"467","Jordan Pickford",5,27,"1994","03","07","2018/2019","Goalkeeper","Everton",3420,1710,1710,"England",38,19,19,0,0,0,0,0,0,0,0,14,9,5,44,20,24,1,0,409,260,57
"468","Jordan Pickford",5,27,"1994","03","07","2019/2020","Goalkeeper","Everton",3420,1710,1710,"England",38,19,19,0,0,0,0,0,0,0,0,9,6,3,49,18,31,2,0,365,358,89
"469","Jordan Pickford",5,27,"1994","03","07","2020/2021","Goalkeeper","Everton",2743,1483,1260,"England",31,17,14,0,0,0,0,0,0,0,0,10,3,7,36,22,14,1,0,399,398,70
"470","Jordan Pickford",5,27,"1994","03","07","2021/2022","Goalkeeper","Everton",1080,540,540,"England",12,6,6,0,0,0,0,0,0,0,0,3,2,1,16,7,9,1,0,228,233,72
"471","Joseph Willock",5,21,"1999","08","19","2017/2018","Midfielder","Arsenal",82,0,82,"England",2,0,2,0,0,0,0,0,0,0,0,0,0,0,1,0,1,0,0,-1,-1,-1
"472","Joseph Willock",5,21,"1999","08","20","2018/2019","Midfielder","Arsenal",64,0,64,"England",2,0,2,0,0,0,0,0,0,0,0,0,0,0,0,0,0,0,0,-1,-1,-1
"473","Joseph Willock",5,21,"1999","08","20","2019/2020","Midfielder","Arsenal",844,340,504,"England",29,12,17,1,0,1,1,0,1,0,0,8,3,5,15,6,9,2,0,138,121,-1
"474","Joseph Willock",5,22,"1999","08","20","2020/2021","Midfielder","Newcastle United",1214,604,610,"England",21,10,11,8,5,3,0,0,0,0,1,5,1,4,18,11,7,1,0,9,340,-1
"475","Joseph Willock",5,22,"1999","08","20","2021/2022","Midfielder","Newcastle United",826,419,407,"England",12,6,6,0,0,0,0,0,0,0,0,0,0,0,19,10,9,0,0,200,182,-1
"476","Joshua King",5,29,"1992","01","15","2017/2018","Forward","AFC Bournemouth",2456,1241,1215,"Norway",33,17,16,8,3,5,3,3,0,2,0,6,3,3,34,17,17,3,0,56,123,-1
"477","Joshua King",5,29,"1992","01","15","2018/2019","Forward","AFC Bournemouth",2974,1563,1411,"Norway",35,18,17,12,9,3,3,3,0,5,1,9,6,3,54,20,34,3,0,49,157,-1
"478","Joshua King",5,29,"1992","01","15","2019/2020","Forward","AFC Bournemouth",2020,1000,1020,"Norway",26,13,13,6,3,3,4,2,2,3,0,5,3,2,37,17,20,0,0,60,65,-1
"479","Joshua King",5,29,"1992","01","15","2020/2021","Forward","Everton",137,93,44,"Norway",11,6,5,0,0,0,0,0,0,0,0,3,1,2,2,2,0,0,0,-1,-1,-1
"480","Joshua King",5,29,"1992","01","15","2021/2022","Forward","Watford",818,323,495,"Norway",11,4,7,5,1,4,2,1,1,1,0,0,0,0,13,3,10,2,0,10,53,-1
"481","Juan Mata",5,32,"1988","04","27","2017/2018","Midfielder","Manchester United",1933,1233,700,"Spain",28,16,12,3,1,2,5,4,1,0,0,15,11,4,10,5,5,1,0,127,46,-1
"482","Juan Mata",5,32,"1988","04","28","2018/2019","Midfielder","Manchester United",1294,833,461,"Spain",22,13,9,3,3,0,2,2,0,0,0,4,2,2,14,6,8,3,0,92,103,-1
"483","Juan Mata",5,32,"1988","04","28","2019/2020","Midfielder","Manchester United",753,468,285,"Spain",19,11,8,0,0,0,2,2,0,0,0,5,5,0,6,4,2,1,0,387,35,-1
"484","Juan Mata",5,33,"1988","04","28","2020/2021","Midfielder","Manchester United",510,212,298,"Spain",9,4,5,1,0,1,2,0,2,1,0,2,2,0,6,2,4,0,0,95,8,-1
"485","Juan Mata",5,33,"1988","04","28","2021/2022","Midfielder","Manchester United",0,0,0,"Spain",0,0,0,0,0,0,0,0,0,0,0,0,0,0,0,0,0,0,0,-1,-1,-1
"486","Karl Darlow",5,30,"1990","10","07","2017/2018","Goalkeeper","Newcastle United",900,450,450,"England",10,5,5,0,0,0,0,0,0,0,0,2,1,1,15,6,9,0,0,367,340,136
"487","Karl Darlow",5,30,"1990","10","08","2018/2019","Goalkeeper","Newcastle United",0,0,0,"England",0,0,0,0,0,0,0,0,0,0,0,0,0,0,0,0,0,0,0,-1,-1,-1
"488","Karl Darlow",5,30,"1990","10","08","2019/2020","Goalkeeper","Newcastle United",0,0,0,"England",0,0,0,0,0,0,0,0,0,0,0,0,0,0,0,0,0,0,0,-1,-1,-1
"489","Karl Darlow",5,31,"1990","10","08","2020/2021","Goalkeeper","Newcastle United",2250,1080,1170,"England",25,12,13,0,0,0,0,0,0,0,0,4,1,3,40,18,22,3,0,320,311,127
"490","Karl Darlow",5,31,"1990","10","08","2021/2022","Goalkeeper","Newcastle United",720,360,360,"England",8,4,4,0,0,0,0,0,0,0,0,0,0,0,15,10,5,1,0,168,208,113
"491","Kasper Schmeichel",5,34,"1986","11","05","2017/2018","Goalkeeper","Leicester City",2966,1440,1526,"Denmark",33,16,17,0,0,0,0,0,0,0,0,8,5,3,45,18,27,3,0,332,246,96
"492","Kasper Schmeichel",5,34,"1986","11","05","2018/2019","Goalkeeper","Leicester City",3420,1710,1710,"Denmark",38,19,19,0,0,0,0,0,0,0,0,10,6,4,43,18,25,3,0,342,302,50
"493","Kasper Schmeichel",5,34,"1986","11","05","2019/2020","Goalkeeper","Leicester City",3420,1710,1710,"Denmark",38,19,19,0,0,0,0,0,0,0,0,13,8,5,38,16,22,2,0,393,324,37
"494","Kasper Schmeichel",5,35,"1986","11","05","2020/2021","Goalkeeper","Leicester City",3420,1710,1710,"Denmark",38,19,19,0,0,0,0,0,0,0,0,11,6,5,48,28,20,0,0,333,326,84
"495","Kasper Schmeichel",5,35,"1986","11","05","2021/2022","Goalkeeper","Leicester City",1170,630,540,"Denmark",13,7,6,0,0,0,0,0,0,0,0,1,1,0,23,12,11,1,0,293,295,101
"496","Kelechi Iheanacho",5,24,"1996","10","02","2017/2018","Forward","Leicester City",867,445,422,"Nigeria",21,11,10,3,1,2,3,1,2,0,0,3,2,1,18,4,14,2,0,52,17,-1
"497","Kelechi Iheanacho",5,24,"1996","10","03","2018/2019","Forward","Leicester City",926,408,518,"Nigeria",30,14,16,1,1,0,3,2,1,0,0,6,4,2,11,5,6,2,0,169,24,-1
"498","Kelechi Iheanacho",5,24,"1996","10","03","2019/2020","Forward","Leicester City",962,452,510,"Nigeria",20,10,10,5,2,3,3,2,1,0,0,4,3,1,8,3,5,1,0,26,28,-1
"499","Kelechi Iheanacho",5,25,"1996","10","03","2020/2021","Forward","Leicester City",1456,748,708,"Nigeria",25,13,12,12,6,6,2,1,1,0,1,7,4,3,22,13,9,1,0,2,115,-1
"500","Kelechi Iheanacho",5,25,"1996","10","03","2021/2022","Forward","Leicester City",438,230,208,"Nigeria",11,6,5,1,0,1,2,2,0,0,0,1,1,0,7,4,3,0,0,73,11,-1
"501","Kevin De Bruyne",5,29,"1991","06","27","2017/2018","Midfielder","Manchester City",3085,1427,1658,"Belgium",37,18,19,8,5,3,16,12,4,0,0,18,8,10,20,8,12,2,0,75,4,-1
"502","Kevin De Bruyne",5,29,"1991","06","28","2018/2019","Midfielder","Manchester City",974,477,497,"Belgium",19,9,10,2,2,0,2,0,2,0,0,12,6,6,3,1,2,2,0,109,75,-1
"503","Kevin De Bruyne",5,29,"1991","06","28","2019/2020","Midfielder","Manchester City",2800,1403,1397,"Belgium",35,17,18,13,9,4,20,12,8,2,0,17,10,7,21,9,12,3,0,31,1,-1
"504","Kevin De Bruyne",5,30,"1991","06","28","2020/2021","Midfielder","Manchester City",2001,1192,809,"Belgium",25,14,11,6,4,2,12,8,4,2,1,12,7,5,17,13,4,1,0,63,2,-1
"505","Kevin De Bruyne",5,30,"1991","06","28","2021/2022","Midfielder","Manchester City",453,168,285,"Belgium",8,3,5,2,1,1,0,0,0,0,0,4,2,2,4,1,3,0,0,29,172,-1
"506","Kevin Long",5,30,"1990","08","17","2017/2018","Defender","Burnley",1440,810,630,"Republic of Ireland",16,9,7,1,1,0,2,0,2,0,0,4,3,1,18,8,10,1,0,192,101,60
"507","Kevin Long",5,30,"1990","08","18","2018/2019","Defender","Burnley",513,90,423,"Republic of Ireland",6,1,5,0,0,0,1,0,1,0,0,1,0,1,7,2,5,0,0,293,72,70
"508","Kevin Long",5,30,"1990","08","18","2019/2020","Defender","Burnley",562,270,292,"Republic of Ireland",8,3,5,0,0,0,0,0,0,0,0,3,0,3,5,4,1,0,0,321,409,12
"509","Kevin Long",5,31,"1990","08","18","2020/2021","Defender","Burnley",636,360,276,"Republic of Ireland",8,4,4,0,0,0,0,0,0,0,0,2,0,2,13,6,7,2,0,367,384,148
"510","Kevin Long",5,31,"1990","08","18","2021/2022","Defender","Burnley",0,0,0,"Republic of Ireland",0,0,0,0,0,0,0,0,0,0,0,0,0,0,0,0,0,0,0,-1,-1,-1
"511","Kurt Zouma",5,26,"1994","10","27","2017/2018","Defender","Stoke City",2887,1381,1506,"France",34,17,17,1,0,1,0,0,0,0,0,6,3,3,48,21,27,1,0,240,372,135
"512","Kurt Zouma",5,26,"1994","10","27","2018/2019","Defender","Everton",2610,1350,1260,"France",32,16,16,2,1,1,2,0,2,0,0,11,8,3,37,17,20,5,1,192,185,83
"513","Kurt Zouma",5,26,"1994","10","27","2019/2020","Defender","Chelsea",2342,1128,1214,"France",28,14,14,0,0,0,0,0,0,0,0,7,6,1,37,8,29,6,0,391,406,112
"514","Kurt Zouma",5,27,"1994","10","27","2020/2021","Defender","Chelsea",2027,1172,855,"France",24,14,10,5,2,3,0,0,0,0,0,9,6,3,22,14,8,3,0,79,367,34
"515","Kurt Zouma",5,27,"1994","10","27","2021/2022","Defender","West Ham United",810,360,450,"France",9,4,5,1,1,0,0,0,0,0,0,2,1,1,9,5,4,1,0,115,228,46
"516","Kyle Walker",5,30,"1990","05","27","2017/2018","Defender","Manchester City",2787,1394,1393,"England",32,16,16,0,0,0,6,2,4,0,0,15,7,8,20,9,11,4,1,359,65,10
"517","Kyle Walker",5,30,"1990","05","28","2018/2019","Defender","Manchester City",2777,1245,1532,"England",33,15,18,1,1,0,1,0,1,0,0,18,7,11,17,9,8,3,0,250,248,10
"518","Kyle Walker",5,30,"1990","05","28","2019/2020","Defender","Manchester City",2397,1073,1324,"England",29,14,15,1,1,0,4,2,2,0,0,14,8,6,24,6,18,5,0,239,87,27
"519","Kyle Walker",5,31,"1990","05","28","2020/2021","Defender","Manchester City",1946,968,978,"England",24,13,11,1,0,1,1,1,0,0,0,10,6,4,20,10,10,1,0,227,208,25
"520","Kyle Walker",5,31,"1990","05","28","2021/2022","Defender","Manchester City",946,496,450,"England",11,6,5,0,0,0,0,0,0,0,0,7,4,3,5,2,3,1,0,197,176,15
"521","Kyle Walker-Peters",5,23,"1997","04","12","2017/2018","Defender","Tottenham Hotspur",188,90,98,"England",3,1,2,0,0,0,2,2,0,0,0,2,0,2,4,4,0,0,0,-1,-1,-1
"522","Kyle Walker-Peters",5,23,"1997","04","13","2018/2019","Defender","Tottenham Hotspur",374,272,102,"England",6,4,2,0,0,0,3,3,0,0,0,3,2,1,4,2,2,1,0,357,1,25
"523","Kyle Walker-Peters",5,24,"1997","04","13","2019/2020","Defender","Southampton",943,493,450,"England",13,7,6,0,0,0,0,0,0,0,0,3,1,2,12,6,6,1,0,414,391,58
"524","Kyle Walker-Peters",5,24,"1997","04","13","2020/2021","Defender","Southampton",2649,1422,1227,"England",30,16,14,0,0,0,2,2,0,0,0,9,6,3,34,18,16,4,0,357,175,65
"525","Kyle Walker-Peters",5,24,"1997","04","13","2021/2022","Defender","Southampton",627,175,452,"England",9,3,6,0,0,0,0,0,0,0,0,3,1,2,7,1,6,3,0,304,305,48
"526","Lewis Dunk",5,29,"1991","11","21","2017/2018","Defender","Brighton & Hove Albion",3420,1710,1710,"England",38,19,19,1,1,0,1,0,1,0,0,10,5,5,52,23,29,7,0,234,243,97
"527","Lewis Dunk",5,29,"1991","11","21","2018/2019","Defender","Brighton & Hove Albion",3153,1550,1603,"England",36,18,18,2,0,2,1,0,1,0,0,7,5,2,53,24,29,7,1,203,252,120
"528","Lewis Dunk",5,29,"1991","11","21","2019/2020","Defender","Brighton & Hove Albion",3231,1611,1620,"England",36,18,18,3,1,2,3,2,1,0,0,9,4,5,47,23,24,9,0,182,161,92
"529","Lewis Dunk",5,29,"1991","11","21","2020/2021","Defender","Brighton & Hove Albion",2933,1350,1583,"England",33,15,18,5,1,4,0,0,0,0,0,11,6,5,36,16,20,7,2,116,375,50
"530","Lewis Dunk",5,29,"1991","11","21","2021/2022","Defender","Brighton & Hove Albion",1170,630,540,"England",13,7,6,0,0,0,0,0,0,0,0,5,3,2,13,7,6,0,0,212,219,47
"531","Lucas Rodrigues Moura da Silva",5,28,"1992","08","12","2017/2018","Midfielder","Tottenham Hotspur",208,98,110,"Brazil",6,3,3,0,0,0,1,1,0,0,0,2,1,1,5,4,1,0,0,-1,-1,-1
"532","Lucas Rodrigues Moura da Silva",5,28,"1992","08","13","2018/2019","Midfielder","Tottenham Hotspur",2127,1040,1087,"Brazil",32,15,17,10,6,4,0,0,0,0,0,12,7,5,16,9,7,3,0,30,279,-1
"533","Lucas Rodrigues Moura da Silva",5,28,"1992","08","13","2019/2020","Midfielder","Tottenham Hotspur",2246,1160,1086,"Brazil",35,17,18,4,1,3,4,4,0,0,0,8,6,2,27,12,15,3,0,108,85,-1
"534","Lucas Rodrigues Moura da Silva",5,29,"1992","08","13","2020/2021","Midfielder","Tottenham Hotspur",1401,690,711,"Brazil",30,13,17,3,2,1,4,2,2,0,0,10,5,5,16,8,8,1,0,90,19,-1
"535","Lucas Rodrigues Moura da Silva",5,29,"1992","08","13","2021/2022","Midfielder","Tottenham Hotspur",841,343,498,"Brazil",11,5,6,0,0,0,1,1,0,0,0,4,2,2,11,3,8,2,0,186,107,-1
"536","Luka Milivojević",5,29,"1991","04","06","2017/2018","Midfielder","Crystal Palace",3082,1565,1517,"Serbia",36,19,17,10,4,6,1,1,0,7,1,8,4,4,51,24,27,8,0,58,239,-1
"537","Luka Milivojević",5,29,"1991","04","07","2018/2019","Midfielder","Crystal Palace",3420,1710,1710,"Serbia",38,19,19,12,7,5,2,0,2,10,1,12,7,5,47,20,27,10,0,59,210,-1
"538","Luka Milivojević",5,30,"1991","04","07","2019/2020","Midfielder","Crystal Palace",2514,1270,1244,"Serbia",31,16,15,3,1,2,1,0,1,2,0,8,5,3,36,15,21,12,0,143,225,-1
"539","Luka Milivojević",5,30,"1991","04","07","2020/2021","Midfielder","Crystal Palace",2364,1069,1295,"Serbia",31,14,17,1,1,0,1,0,1,1,1,8,6,2,44,21,23,9,1,237,213,-1
"540","Luka Milivojević",5,30,"1991","04","07","2021/2022","Midfielder","Crystal Palace",472,318,154,"Serbia",7,5,2,0,0,0,0,0,0,0,0,1,1,0,8,4,4,1,0,166,187,-1
"541","Łukasz Fabiański",5,35,"1985","04","17","2017/2018","Goalkeeper","Swansea City",3420,1710,1710,"Poland",38,19,19,0,0,0,0,0,0,0,0,9,5,4,53,23,30,0,0,320,393,102
"542","Łukasz Fabiański",5,35,"1985","04","18","2018/2019","Goalkeeper","West Ham United",3420,1710,1710,"Poland",38,19,19,0,0,0,0,0,0,0,0,7,4,3,48,23,25,0,0,391,343,81
"543","Łukasz Fabiański",5,36,"1985","04","18","2019/2020","Goalkeeper","West Ham United",2119,1170,949,"Poland",25,13,12,0,0,0,0,0,0,0,0,5,3,2,33,19,14,1,0,341,271,109
"544","Łukasz Fabiański",5,36,"1985","04","18","2020/2021","Goalkeeper","West Ham United",3150,1710,1440,"Poland",35,19,16,0,0,0,0,0,0,0,0,10,6,4,42,21,21,2,0,316,304,75
"545","Łukasz Fabiański",5,36,"1985","04","18","2021/2022","Goalkeeper","West Ham United",1170,540,630,"Poland",13,6,7,0,0,0,0,0,0,0,0,3,1,2,14,8,6,0,0,152,150,50
"546","Luke Shaw",5,25,"1995","07","11","2017/2018","Defender","Manchester United",788,473,315,"England",11,6,5,0,0,0,0,0,0,0,0,8,5,3,2,2,0,2,0,252,287,2
"547","Luke Shaw",5,25,"1995","07","12","2018/2019","Defender","Manchester United",2592,1170,1422,"England",29,13,16,1,1,0,4,2,2,0,0,6,1,5,36,16,20,11,0,262,105,77
"548","Luke Shaw",5,25,"1995","07","12","2019/2020","Defender","Manchester United",1734,864,870,"England",24,13,11,0,0,0,0,0,0,0,0,9,5,4,15,6,9,7,0,385,350,9
"549","Luke Shaw",5,26,"1995","07","12","2020/2021","Defender","Manchester United",2655,1328,1327,"England",32,17,15,1,0,1,5,3,2,0,0,12,5,7,30,21,9,8,0,255,77,38
"550","Luke Shaw",5,26,"1995","07","12","2021/2022","Defender","Manchester United",1001,467,534,"England",12,6,6,0,0,0,1,1,0,0,0,2,0,2,17,10,7,4,0,245,121,88
"551","Manuel Lanzini",5,28,"1993","02","15","2017/2018","Midfielder","West Ham United",2047,973,1074,"Argentina",27,13,14,5,3,2,6,2,4,0,1,6,4,2,42,17,25,4,0,78,29,-1
"552","Manuel Lanzini",5,28,"1993","02","15","2018/2019","Midfielder","West Ham United",688,367,321,"Argentina",10,5,5,1,0,1,1,0,1,0,0,2,2,0,11,5,6,2,0,130,111,-1
"553","Manuel Lanzini",5,28,"1993","02","15","2019/2020","Midfielder","West Ham United",1377,680,697,"Argentina",24,13,11,0,0,0,2,1,1,0,0,3,2,1,27,16,11,1,0,354,100,-1
"554","Manuel Lanzini",5,28,"1993","02","15","2020/2021","Midfielder","West Ham United",558,331,227,"Argentina",17,9,8,1,0,1,1,1,0,0,0,6,3,3,5,4,1,1,0,108,89,-1
"555","Manuel Lanzini",5,28,"1993","02","15","2021/2022","Midfielder","West Ham United",109,18,91,"Argentina",7,3,4,1,0,1,1,0,1,0,0,2,1,1,1,1,0,0,0,-1,-1,-1
"556","Marc Albrighton",5,31,"1989","11","18","2017/2018","Midfielder","Leicester City",2544,1357,1187,"England",34,17,17,2,1,1,7,3,4,0,0,9,6,3,38,17,21,6,1,190,34,-1
"557","Marc Albrighton",5,31,"1989","11","18","2018/2019","Midfielder","Leicester City",1626,797,829,"England",27,14,13,2,1,1,2,1,1,0,0,9,5,4,17,8,9,3,0,156,140,-1
"558","Marc Albrighton",5,31,"1989","11","18","2019/2020","Midfielder","Leicester City",863,388,475,"England",20,8,12,0,0,0,3,3,0,0,0,6,4,2,10,5,5,2,0,380,22,-1
"559","Marc Albrighton",5,31,"1989","11","18","2020/2021","Midfielder","Leicester City",1741,886,855,"England",31,15,16,1,1,0,5,2,3,0,0,11,6,5,22,12,10,2,0,228,20,-1
"560","Marc Albrighton",5,31,"1989","11","18","2021/2022","Midfielder","Leicester City",295,195,100,"England",5,3,2,1,0,1,0,0,0,0,0,0,0,0,5,4,1,1,0,44,313,-1
"561","Marcos Alonso",5,30,"1990","12","28","2017/2018","Defender","Chelsea",2860,1591,1269,"Spain",33,18,15,7,3,4,2,0,2,0,0,14,9,5,27,15,12,6,0,82,184,30
"562","Marcos Alonso",5,30,"1990","12","28","2018/2019","Defender","Chelsea",2761,1338,1423,"Spain",31,15,16,2,1,1,4,3,1,0,0,14,8,6,28,9,19,6,0,191,112,22
"563","Marcos Alonso",5,30,"1990","12","28","2019/2020","Defender","Chelsea",1430,695,735,"Spain",18,8,10,4,2,2,2,0,2,0,0,6,5,1,18,3,15,4,0,70,96,52
"564","Marcos Alonso",5,30,"1990","12","28","2020/2021","Defender","Chelsea",960,526,434,"Spain",13,7,6,2,1,1,0,0,0,0,0,6,5,1,12,6,6,2,0,87,366,59
"565","Marcos Alonso",5,30,"1990","12","28","2021/2022","Defender","Chelsea",614,344,270,"Spain",7,4,3,1,1,0,1,0,1,0,0,4,2,2,3,2,1,2,0,94,86,13
"566","Marcus Rashford",5,23,"1997","10","31","2017/2018","Forward","Manchester United",1805,1015,790,"England",35,18,17,7,5,2,5,4,1,0,0,19,12,7,15,7,8,3,0,42,32,-1
"567","Marcus Rashford",5,23,"1997","10","31","2018/2019","Forward","Manchester United",2362,1293,1069,"England",33,17,16,10,4,6,6,3,3,0,0,6,2,4,34,17,17,4,1,41,52,-1
"568","Marcus Rashford",5,23,"1997","10","31","2019/2020","Forward","Manchester United",2655,1257,1398,"England",31,15,16,17,12,5,7,3,4,6,2,9,4,5,26,12,14,3,0,17,39,-1
"569","Marcus Rashford",5,24,"1997","10","31","2020/2021","Forward","Manchester United",2927,1497,1430,"England",37,19,18,11,5,6,9,2,7,0,0,13,6,7,35,23,12,4,0,43,14,-1
"570","Marcus Rashford",5,24,"1997","10","31","2021/2022","Forward","Manchester United",252,85,167,"England",6,2,4,2,0,2,0,0,0,0,0,1,0,1,10,5,5,1,0,-1,-1,-1
"571","Mark Noble",5,33,"1987","05","07","2017/2018","Midfielder","West Ham United",2404,1247,1157,"England",29,15,14,4,1,3,0,0,0,2,0,8,6,2,43,17,26,6,0,119,370,-1
"572","Mark Noble",5,33,"1987","05","08","2018/2019","Midfielder","West Ham United",2308,1147,1161,"England",31,15,16,5,2,3,5,4,1,4,0,7,4,3,29,12,17,7,1,96,70,-1
"573","Mark Noble",5,33,"1987","05","08","2019/2020","Midfielder","West Ham United",2686,1286,1400,"England",33,15,18,4,2,2,3,2,1,3,0,7,3,4,43,22,21,5,0,127,135,-1
"574","Mark Noble",5,34,"1987","05","08","2020/2021","Midfielder","West Ham United",705,343,362,"England",21,12,9,0,0,0,0,0,0,0,0,6,3,3,14,6,8,1,0,318,307,-1
"575","Mark Noble",5,34,"1987","05","08","2021/2022","Midfielder","West Ham United",2,2,0,"England",2,2,0,0,0,0,0,0,0,0,1,0,0,0,0,0,0,0,0,-1,-1,-1
"576","Martin Dúbravka",5,32,"1989","01","15","2017/2018","Goalkeeper","Newcastle United",1080,540,540,"Slovakia",12,6,6,0,0,0,0,0,0,0,0,4,4,0,11,2,9,0,0,253,265,46
"577","Martin Dúbravka",5,32,"1989","01","15","2018/2019","Goalkeeper","Newcastle United",3420,1710,1710,"Slovakia",38,19,19,0,0,0,0,0,0,0,0,11,5,6,44,23,21,1,0,345,317,58
"578","Martin Dúbravka",5,32,"1989","01","15","2019/2020","Goalkeeper","Newcastle United",3420,1710,1710,"Slovakia",38,19,19,0,0,0,0,0,0,0,0,11,7,4,51,20,31,0,0,375,375,102
"579","Martin Dúbravka",5,32,"1989","01","15","2020/2021","Goalkeeper","Newcastle United",1170,630,540,"Slovakia",13,7,6,0,0,0,0,0,0,0,0,3,1,2,19,12,7,0,0,265,268,111
"580","Martin Dúbravka",5,32,"1989","01","15","2021/2022","Goalkeeper","Newcastle United",180,90,90,"Slovakia",2,1,1,0,0,0,0,0,0,0,0,0,0,0,3,1,2,0,0,-1,-1,-1
"581","Martin Kelly",5,30,"1990","04","26","2017/2018","Defender","Crystal Palace",1194,514,680,"England",15,7,8,0,0,0,0,0,0,0,0,4,2,2,20,10,10,1,0,262,383,137
"582","Martin Kelly",5,30,"1990","04","27","2018/2019","Defender","Crystal Palace",1110,660,450,"England",13,8,5,0,0,0,0,0,0,0,0,3,2,1,18,11,7,2,0,326,350,110
"583","Martin Kelly",5,31,"1990","04","27","2019/2020","Defender","Crystal Palace",1550,701,849,"England",19,9,10,0,0,0,1,0,1,0,0,6,4,2,16,6,10,0,0,332,204,32
"584","Martin Kelly",5,31,"1990","04","27","2020/2021","Defender","Crystal Palace",1,0,1,"England",1,0,1,0,0,0,0,0,0,0,0,0,0,0,0,0,0,0,0,-1,-1,-1
"585","Martin Kelly",5,31,"1990","04","27","2021/2022","Defender","Crystal Palace",0,0,0,"England",0,0,0,0,0,0,0,0,0,0,0,0,0,0,0,0,0,0,0,-1,-1,-1
"586","Mason Holgate",5,24,"1996","10","21","2017/2018","Defender","Everton",1182,552,630,"England",15,7,8,0,0,0,0,0,0,0,0,5,3,2,14,5,9,3,0,310,382,58
"587","Mason Holgate",5,24,"1996","10","22","2018/2019","Defender","Everton",407,270,137,"England",5,3,2,0,0,0,0,0,0,0,0,0,0,0,9,5,4,1,0,414,390,160
"588","Mason Holgate",5,24,"1996","10","22","2019/2020","Defender","Everton",2053,937,1116,"England",27,14,13,0,0,0,3,0,3,0,0,7,6,1,28,5,23,5,0,397,102,70
"589","Mason Holgate",5,25,"1996","10","22","2020/2021","Defender","Everton",2289,1181,1108,"England",28,15,13,1,0,1,0,0,0,0,0,11,3,8,31,19,12,9,0,231,262,78
"590","Mason Holgate",5,25,"1996","10","22","2021/2022","Defender","Everton",278,98,180,"England",4,2,2,0,0,0,0,0,0,0,0,2,1,1,3,1,2,1,1,232,264,42
"591","Matt Ritchie",5,31,"1989","09","09","2017/2018","Midfielder","Newcastle United",2812,1441,1371,"Scotland",35,18,17,3,3,0,5,3,2,0,0,9,7,2,34,14,20,6,0,149,74,-1
"592","Matt Ritchie",5,31,"1989","09","10","2018/2019","Midfielder","Newcastle United",2940,1557,1383,"Scotland",36,19,17,2,1,1,8,2,6,1,1,11,5,6,37,21,16,9,0,216,46,-1
"593","Matt Ritchie",5,31,"1989","09","10","2019/2020","Midfielder","Newcastle United",1316,705,611,"Scotland",18,9,9,2,2,0,1,1,0,0,1,7,4,3,16,6,10,4,0,113,184,-1
"594","Matt Ritchie",5,32,"1989","09","10","2020/2021","Midfielder","Newcastle United",1352,818,534,"Scotland",18,10,8,0,0,0,2,1,1,0,0,4,2,2,22,15,7,2,0,327,107,-1
"595","Matt Ritchie",5,32,"1989","09","10","2021/2022","Midfielder","Newcastle United",1147,540,607,"Scotland",13,6,7,0,0,0,2,2,0,0,0,0,0,0,27,15,12,5,0,155,80,-1
"596","Matt Targett",5,25,"1995","09","17","2017/2018","Defender","Southampton",167,90,77,"England",2,1,1,0,0,0,0,0,0,0,0,0,0,0,6,1,5,0,0,-1,-1,-1
"597","Matt Targett",5,25,"1995","09","18","2018/2019","Defender","Southampton",1185,483,702,"England",16,7,9,1,1,0,3,2,1,0,0,1,0,1,24,10,14,2,0,183,51,151
"598","Matt Targett",5,25,"1995","09","18","2019/2020","Defender","Aston Villa",2295,1104,1191,"England",28,14,14,1,1,0,2,0,2,0,0,5,5,0,37,14,23,4,0,234,165,115
"599","Matt Targett",5,26,"1995","09","18","2020/2021","Defender","Aston Villa",3405,1710,1695,"England",38,19,19,0,0,0,2,1,1,0,0,15,7,8,42,27,15,7,0,384,200,53
"600","Matt Targett",5,26,"1995","09","18","2021/2022","Defender","Aston Villa",1007,421,586,"England",12,5,7,1,0,1,1,0,1,0,0,3,2,1,17,7,10,2,0,128,120,87
"601","Matthew Lowton",5,31,"1989","06","08","2017/2018","Defender","Burnley",2294,1214,1080,"England",26,14,12,0,0,0,3,2,1,0,0,8,5,3,23,7,16,1,0,326,110,41
"602","Matthew Lowton",5,31,"1989","06","09","2018/2019","Defender","Burnley",1748,810,938,"England",21,9,12,0,0,0,0,0,0,0,0,4,2,2,35,16,19,7,0,378,342,150
"603","Matthew Lowton",5,31,"1989","06","09","2019/2020","Defender","Burnley",1530,630,900,"England",17,7,10,0,0,0,1,0,1,0,0,6,5,1,30,7,23,2,0,318,195,143
"604","Matthew Lowton",5,32,"1989","06","09","2020/2021","Defender","Burnley",3060,1620,1440,"England",34,18,16,1,0,1,1,0,1,0,0,10,3,7,46,26,20,5,0,249,225,96
"605","Matthew Lowton",5,32,"1989","06","09","2021/2022","Defender","Burnley",1080,540,540,"England",12,6,6,1,1,0,2,1,1,0,0,1,1,0,20,8,12,1,0,138,77,95
"606","Michael Keane",5,28,"1993","01","11","2017/2018","Defender","Everton",2561,1270,1291,"England",30,15,15,0,0,0,1,1,0,0,0,8,6,2,43,17,26,3,0,306,210,138
"607","Michael Keane",5,28,"1993","01","11","2018/2019","Defender","Everton",2970,1350,1620,"England",33,15,18,1,0,1,2,1,1,0,0,13,8,5,37,15,22,2,0,251,196,49
"608","Michael Keane",5,28,"1993","01","11","2019/2020","Defender","Everton",2556,1278,1278,"England",31,15,16,2,0,2,0,0,0,0,0,8,5,3,38,16,22,3,0,194,369,99
"609","Michael Keane",5,28,"1993","01","11","2020/2021","Defender","Everton",2990,1474,1516,"England",35,17,18,3,2,1,1,0,1,0,0,11,3,8,40,21,19,4,0,159,234,76
"610","Michael Keane",5,28,"1993","01","11","2021/2022","Defender","Everton",1170,540,630,"England",13,6,7,1,1,0,2,1,1,0,0,3,2,1,19,7,12,0,0,143,85,81
"611","Michail Antonio",5,30,"1990","03","27","2017/2018","Midfielder","West Ham United",1357,707,650,"England",21,10,11,3,0,3,1,1,0,0,0,8,6,2,22,8,14,1,0,95,172,-1
"612","Michail Antonio",5,31,"1990","03","28","2018/2019","Midfielder","West Ham United",2099,998,1101,"England",33,16,17,6,4,2,4,2,2,0,0,5,3,2,26,10,16,3,0,77,85,-1
"613","Michail Antonio",5,31,"1990","03","28","2019/2020","Midfielder","West Ham United",1770,785,985,"England",24,11,13,10,4,6,3,2,1,1,0,3,0,3,29,14,15,3,0,21,90,-1
"614","Michail Antonio",5,31,"1990","03","28","2020/2021","Midfielder","West Ham United",1984,958,1026,"England",26,12,14,10,4,6,5,2,3,0,0,8,4,4,25,12,13,3,0,27,34,-1
"615","Michail Antonio",5,31,"1990","03","28","2021/2022","Midfielder","West Ham United",1079,449,630,"England",12,5,7,6,4,2,3,2,1,0,1,3,1,2,12,6,6,4,1,16,33,-1
"616","Mohamed Salah",5,28,"1992","06","14","2017/2018","Forward","Liverpool",2922,1556,1366,"Egypt",36,19,17,32,19,13,10,8,2,1,1,16,12,4,29,7,22,1,0,1,16,-1
"617","Mohamed Salah",5,28,"1992","06","15","2018/2019","Forward","Liverpool",3262,1692,1570,"Egypt",38,19,19,22,13,9,8,5,3,3,0,21,12,9,18,8,10,1,0,7,57,-1
"618","Mohamed Salah",5,28,"1992","06","15","2019/2020","Forward","Liverpool",2888,1580,1308,"Egypt",34,18,16,19,15,4,10,4,6,3,0,14,7,7,26,13,13,1,0,14,23,-1
"619","Mohamed Salah",5,29,"1992","06","15","2020/2021","Forward","Liverpool",3082,1532,1550,"Egypt",37,18,19,22,9,13,5,3,2,6,0,11,4,7,40,19,21,0,0,6,96,-1
"620","Mohamed Salah",5,29,"1992","06","15","2021/2022","Forward","Liverpool",1170,630,540,"Egypt",13,7,6,11,4,7,8,3,5,1,0,8,4,4,11,5,6,1,0,3,4,-1
"621","Moussa Sissoko",5,31,"1989","08","15","2017/2018","Midfielder","Tottenham Hotspur",1393,650,743,"France",33,17,16,1,0,1,1,0,1,0,0,14,9,5,16,9,7,3,0,193,189,-1
"622","Moussa Sissoko",5,31,"1989","08","16","2018/2019","Midfielder","Tottenham Hotspur",2336,1187,1149,"France",29,15,14,0,0,0,3,2,1,0,0,11,6,5,26,10,16,2,0,354,131,-1
"623","Moussa Sissoko",5,31,"1989","08","16","2019/2020","Midfielder","Tottenham Hotspur",2455,1350,1105,"France",29,15,14,2,2,0,1,1,0,0,0,6,5,1,28,11,17,8,0,185,228,-1
"624","Moussa Sissoko",5,32,"1989","08","16","2020/2021","Midfielder","Tottenham Hotspur",1575,738,837,"France",25,12,13,0,0,0,0,0,0,0,0,9,4,5,19,9,10,3,0,397,395,-1
"625","Moussa Sissoko",5,32,"1989","08","16","2021/2022","Midfielder","Watford",971,450,521,"France",11,5,6,0,0,0,0,0,0,0,0,0,0,0,19,9,10,2,0,191,206,-1
"626","N'Golo Kanté",5,29,"1991","03","29","2017/2018","Midfielder","Chelsea",2998,1590,1408,"France",34,18,16,1,0,1,1,1,0,0,0,15,10,5,29,13,16,3,0,237,226,-1
"627","N'Golo Kanté",5,30,"1991","03","29","2018/2019","Midfielder","Chelsea",3096,1579,1517,"France",36,19,17,4,2,2,4,3,1,0,0,15,10,5,37,12,25,3,0,141,126,-1
"628","N'Golo Kanté",5,30,"1991","03","29","2019/2020","Midfielder","Chelsea",1733,816,917,"France",22,11,11,3,1,2,0,0,0,0,0,3,2,1,24,9,15,4,0,104,417,-1
"629","N'Golo Kanté",5,30,"1991","03","29","2020/2021","Midfielder","Chelsea",2145,953,1192,"France",30,14,16,0,0,0,2,1,1,0,0,14,7,7,22,10,12,7,0,368,159,-1
"630","N'Golo Kanté",5,30,"1991","03","29","2021/2022","Midfielder","Chelsea",497,145,352,"France",8,2,6,2,0,2,0,0,0,0,0,5,0,5,3,2,1,1,0,33,185,-1
"631","Nathan Aké",5,26,"1995","02","18","2017/2018","Defender","AFC Bournemouth",3353,1710,1643,"Netherlands",38,19,19,2,1,1,3,2,1,0,0,6,3,3,54,28,26,5,0,212,160,119
"632","Nathan Aké",5,26,"1995","02","18","2018/2019","Defender","AFC Bournemouth",3412,1710,1702,"Netherlands",38,19,19,4,3,1,0,0,0,0,0,10,6,4,66,23,43,3,0,150,337,148
"633","Nathan Aké",5,26,"1995","02","18","2019/2020","Defender","AFC Bournemouth",2505,1335,1170,"Netherlands",29,16,13,2,1,1,2,2,0,0,0,4,3,1,45,22,23,2,0,189,168,128
"634","Nathan Aké",5,26,"1995","02","18","2020/2021","Defender","Manchester City",797,508,289,"Netherlands",10,6,4,1,1,0,0,0,0,0,0,3,2,1,12,8,4,4,0,147,242,100
"635","Nathan Aké",5,26,"1995","02","18","2021/2022","Defender","Manchester City",284,194,90,"Netherlands",4,3,1,0,0,0,0,0,0,0,0,3,3,0,1,0,1,0,0,195,188,5
"636","Nathan Redmond",5,27,"1994","03","06","2017/2018","Midfielder","Southampton",1945,944,1001,"England",31,14,17,1,0,1,3,2,1,0,0,8,3,5,29,12,17,3,0,218,91,-1
"637","Nathan Redmond",5,27,"1994","03","06","2018/2019","Midfielder","Southampton",3276,1633,1643,"England",38,19,19,6,4,2,4,2,2,0,0,7,3,4,53,22,31,3,0,116,137,-1
"638","Nathan Redmond",5,27,"1994","03","06","2019/2020","Midfielder","Southampton",2771,1241,1530,"England",32,15,17,4,0,4,4,1,3,0,0,7,2,5,48,28,20,2,0,126,103,-1
"639","Nathan Redmond",5,27,"1994","03","06","2020/2021","Midfielder","Southampton",1731,881,850,"England",29,15,14,2,2,0,3,3,0,0,0,5,4,1,34,11,23,1,0,155,85,-1
"640","Nathan Redmond",5,27,"1994","03","06","2021/2022","Midfielder","Southampton",683,333,350,"England",10,4,6,0,0,0,2,2,0,0,0,4,2,2,6,3,3,0,0,303,29,-1
"641","Nemanja Matić",5,32,"1988","07","31","2017/2018","Midfielder","Manchester United",3119,1620,1499,"Serbia",36,18,18,1,0,1,1,1,0,0,0,17,11,6,25,9,16,6,0,236,235,-1
"642","Nemanja Matić",5,32,"1988","08","01","2018/2019","Midfielder","Manchester United",2441,1051,1390,"Serbia",28,12,16,1,1,0,0,0,0,0,0,6,1,5,35,14,21,8,1,239,257,-1
"643","Nemanja Matić",5,32,"1988","08","01","2019/2020","Midfielder","Manchester United",1583,764,819,"Serbia",21,9,12,0,0,0,2,1,1,0,0,11,5,6,11,6,5,3,0,388,124,-1
"644","Nemanja Matić",5,33,"1988","08","01","2020/2021","Midfielder","Manchester United",1099,553,546,"Serbia",20,9,11,0,0,0,0,0,0,0,0,5,2,3,16,10,6,2,0,280,285,-1
"645","Nemanja Matić",5,33,"1988","08","01","2021/2022","Midfielder","Manchester United",472,110,362,"Serbia",8,2,6,0,0,0,2,0,2,0,0,1,0,1,7,1,6,0,0,249,14,-1
"646","Oleksandr Zinchenko",5,24,"1996","12","15","2017/2018","Midfielder","Manchester City",533,408,125,"Ukraine",8,5,3,0,0,0,0,0,0,0,0,5,2,3,3,3,0,1,0,264,295,-1
"647","Oleksandr Zinchenko",5,24,"1996","12","15","2018/2019","Midfielder","Manchester City",1153,613,540,"Ukraine",14,8,6,0,0,0,3,2,1,0,0,10,6,4,4,2,2,1,0,284,50,-1
"648","Oleksandr Zinchenko",5,24,"1996","12","15","2019/2020","Midfielder","Manchester City",1272,507,765,"Ukraine",19,7,12,0,0,0,0,0,0,0,0,9,4,5,12,4,8,2,1,359,283,-1
"649","Oleksandr Zinchenko",5,24,"1996","12","15","2020/2021","Midfielder","Manchester City",1474,873,601,"Ukraine",20,11,9,0,0,0,0,0,0,0,0,10,6,4,11,6,5,0,0,303,274,-1
"650","Oleksandr Zinchenko",5,24,"1996","12","15","2021/2022","Midfielder","Manchester City",55,44,11,"Ukraine",2,1,1,0,0,0,0,0,0,0,0,1,1,0,0,0,0,0,0,-1,-1,-1
"651","Onyinye Wilfred Ndidi",5,24,"1996","12","16","2017/2018","Midfielder","Leicester City",2899,1411,1488,"Nigeria",33,16,17,0,0,0,3,1,2,0,0,9,6,3,43,16,27,10,2,337,145,-1
"652","Onyinye Wilfred Ndidi",5,24,"1996","12","16","2018/2019","Midfielder","Leicester City",3299,1624,1675,"Nigeria",38,19,19,2,2,0,0,0,0,0,0,10,6,4,42,18,24,8,0,218,332,-1
"653","Onyinye Wilfred Ndidi",5,24,"1996","12","16","2019/2020","Midfielder","Leicester City",2674,1399,1275,"Nigeria",32,16,16,2,1,1,1,0,1,0,0,12,8,4,29,11,18,6,0,183,256,-1
"654","Onyinye Wilfred Ndidi",5,24,"1996","12","16","2020/2021","Midfielder","Leicester City",2179,1216,963,"Nigeria",26,14,12,1,1,0,4,2,2,0,0,7,5,2,30,18,12,6,0,239,74,-1
"655","Onyinye Wilfred Ndidi",5,24,"1996","12","16","2021/2022","Midfielder","Leicester City",810,450,360,"Nigeria",9,5,4,0,0,0,0,0,0,0,0,1,1,0,16,8,8,2,0,310,311,-1
"656","Oriol Romeu",5,29,"1991","09","23","2017/2018","Midfielder","Southampton",2903,1388,1515,"Spain",34,17,17,1,0,1,0,0,0,0,0,8,3,5,43,22,21,11,0,235,403,-1
"657","Oriol Romeu",5,29,"1991","09","24","2018/2019","Midfielder","Southampton",2140,1110,1030,"Spain",31,16,15,1,1,0,0,0,0,0,0,6,3,3,32,16,16,11,0,244,371,-1
"658","Oriol Romeu",5,29,"1991","09","24","2019/2020","Midfielder","Southampton",1856,812,1044,"Spain",30,14,16,0,0,0,0,0,0,0,0,8,3,5,35,20,15,5,0,314,378,-1
"659","Oriol Romeu",5,30,"1991","09","24","2020/2021","Midfielder","Southampton",1767,950,817,"Spain",21,11,10,1,1,0,1,1,0,0,0,6,5,1,22,9,13,6,0,221,205,-1
"660","Oriol Romeu",5,30,"1991","09","24","2021/2022","Midfielder","Southampton",1103,503,600,"Spain",13,6,7,0,0,0,0,0,0,0,0,5,3,2,15,4,11,3,0,299,300,-1
"661","Pascal Groß",5,29,"1991","06","14","2017/2018","Midfielder","Brighton & Hove Albion",2949,1614,1335,"Germany",38,19,19,7,7,0,8,6,2,1,0,10,5,5,44,21,23,2,0,87,38,-1
"662","Pascal Groß",5,29,"1991","06","15","2018/2019","Midfielder","Brighton & Hove Albion",1878,993,885,"Germany",25,13,12,3,2,1,3,1,2,1,1,3,2,1,31,16,15,1,0,126,104,-1
"663","Pascal Groß",5,29,"1991","06","15","2019/2020","Midfielder","Brighton & Hove Albion",1804,846,958,"Germany",29,14,15,2,1,1,4,0,4,0,0,6,3,3,29,13,16,4,0,152,53,-1
"664","Pascal Groß",5,30,"1991","06","15","2020/2021","Midfielder","Brighton & Hove Albion",2482,1307,1175,"Germany",34,17,17,3,3,0,8,3,5,3,1,11,7,4,26,11,15,3,0,144,13,-1
"665","Pascal Groß",5,30,"1991","06","15","2021/2022","Midfielder","Brighton & Hove Albion",797,426,371,"Germany",10,5,5,0,0,0,2,1,1,0,0,4,3,1,8,5,3,0,0,213,45,-1
"666","Paul Pogba",5,28,"1993","03","15","2017/2018","Midfielder","Manchester United",2151,968,1183,"France",27,13,14,6,3,3,10,3,7,0,0,13,8,5,19,5,14,6,1,67,6,-1
"667","Paul Pogba",5,28,"1993","03","15","2018/2019","Midfielder","Manchester United",3011,1517,1494,"France",35,18,17,13,10,3,9,4,5,7,3,7,2,5,41,20,21,6,0,37,30,-1
"668","Paul Pogba",5,28,"1993","03","15","2019/2020","Midfielder","Manchester United",1204,637,567,"France",16,8,8,1,0,1,3,2,1,0,1,6,2,4,8,6,2,1,0,191,44,-1
"669","Paul Pogba",5,28,"1993","03","15","2020/2021","Midfielder","Manchester United",1896,1032,864,"France",26,13,13,3,0,3,3,2,1,0,0,7,3,4,25,17,8,3,0,121,98,-1
"670","Paul Pogba",5,28,"1993","03","15","2021/2022","Midfielder","Manchester United",662,319,343,"France",9,5,4,0,0,0,7,6,1,0,0,1,0,1,9,4,5,5,1,246,1,-1
"671","Phil Bardsley",5,35,"1985","06","27","2017/2018","Defender","Burnley",1126,496,630,"Scotland",13,6,7,0,0,0,0,0,0,0,0,4,2,2,11,6,5,5,0,273,256,39
"672","Phil Bardsley",5,35,"1985","06","28","2018/2019","Defender","Burnley",1672,900,772,"Scotland",19,10,9,0,0,0,0,0,0,0,0,4,3,1,22,11,11,9,0,383,355,62
"673","Phil Bardsley",5,35,"1985","06","28","2019/2020","Defender","Burnley",1890,1080,810,"Scotland",21,12,9,0,0,0,1,1,0,0,0,9,3,6,18,15,3,6,0,322,211,21
"674","Phil Bardsley",5,36,"1985","06","28","2020/2021","Defender","Burnley",273,90,183,"Scotland",4,1,3,0,0,0,0,0,0,0,0,1,0,1,8,1,7,2,0,377,383,160
"675","Phil Bardsley",5,36,"1985","06","28","2021/2022","Defender","Burnley",0,0,0,"Scotland",0,0,0,0,0,0,0,0,0,0,0,0,0,0,0,0,0,0,0,-1,-1,-1
"676","Philip Foden",5,20,"2000","05","27","2017/2018","Midfielder","Manchester City",44,36,8,"England",5,4,1,0,0,0,1,1,0,0,0,3,2,1,0,0,0,0,0,-1,-1,-1
"677","Philip Foden",5,20,"2000","05","28","2018/2019","Midfielder","Manchester City",327,279,48,"England",13,10,3,1,1,0,0,0,0,0,0,8,6,2,0,0,0,0,0,67,386,-1
"678","Philip Foden",5,20,"2000","05","28","2019/2020","Midfielder","Manchester City",892,532,360,"England",23,13,10,5,4,1,2,1,1,0,0,13,8,5,5,2,3,0,0,22,55,-1
"679","Philip Foden",5,21,"2000","05","28","2020/2021","Midfielder","Manchester City",1611,860,751,"England",28,16,12,9,2,7,5,3,2,0,0,12,9,3,14,6,8,0,0,20,16,-1
"680","Philip Foden",5,21,"2000","05","28","2021/2022","Midfielder","Manchester City",613,256,357,"England",8,4,4,3,0,3,1,0,1,0,0,5,3,2,5,2,3,0,0,25,82,-1
"681","Pierre-Emerick Aubameyang",5,31,"1989","06","17","2017/2018","Forward","Arsenal",1058,541,517,"Gabon",13,7,6,10,7,3,4,3,1,1,1,4,3,1,13,5,8,0,0,4,11,-1
"682","Pierre-Emerick Aubameyang",5,31,"1989","06","18","2018/2019","Forward","Arsenal",2731,1418,1313,"Gabon",36,19,17,22,13,9,5,4,1,4,1,8,7,1,40,14,26,0,0,3,88,-1
"683","Pierre-Emerick Aubameyang",5,31,"1989","06","18","2019/2020","Forward","Arsenal",3139,1554,1585,"Gabon",36,18,18,22,13,9,3,2,1,2,0,10,5,5,42,22,20,4,1,7,150,-1
"684","Pierre-Emerick Aubameyang",5,32,"1989","06","18","2020/2021","Forward","Arsenal",2337,1135,1202,"Gabon",29,13,16,10,6,4,3,1,2,2,0,10,3,7,26,15,11,2,0,32,122,-1
"685","Pierre-Emerick Aubameyang",5,32,"1989","06","18","2021/2022","Forward","Arsenal",956,555,401,"Gabon",12,7,5,4,4,0,1,1,0,0,2,6,3,3,12,4,8,3,0,30,128,-1
"686","Pierre-Emile Højbjerg",5,25,"1995","08","04","2017/2018","Midfielder","Southampton",1671,716,955,"Denmark",23,10,13,0,0,0,0,0,0,0,0,3,0,3,27,10,17,6,0,281,293,-1
"687","Pierre-Emile Højbjerg",5,25,"1995","08","05","2018/2019","Midfielder","Southampton",2764,1416,1348,"Denmark",31,16,15,4,2,2,3,2,1,0,0,4,1,3,52,23,29,10,2,136,148,-1
"688","Pierre-Emile Højbjerg",5,25,"1995","08","05","2019/2020","Midfielder","Southampton",2751,1440,1311,"Denmark",33,16,17,0,0,0,1,0,1,0,0,8,2,6,47,30,17,5,0,325,239,-1
"689","Pierre-Emile Højbjerg",5,26,"1995","08","05","2020/2021","Midfielder","Tottenham Hotspur",3420,1710,1710,"Denmark",38,19,19,2,2,0,4,2,2,0,0,12,7,5,40,17,23,9,0,217,127,-1
"690","Pierre-Emile Højbjerg",5,26,"1995","08","05","2021/2022","Midfielder","Tottenham Hotspur",1080,540,540,"Denmark",12,6,6,2,2,0,1,0,1,0,0,4,2,2,15,7,8,1,0,88,133,-1
"691","Raheem Sterling",5,26,"1994","12","08","2017/2018","Forward","Manchester City",2592,1240,1352,"England",33,15,18,18,11,7,11,6,5,1,0,14,5,9,21,11,10,5,1,8,9,-1
"692","Raheem Sterling",5,26,"1994","12","08","2018/2019","Forward","Manchester City",2777,1256,1521,"England",34,16,18,17,12,5,10,6,4,0,0,18,7,11,19,9,10,3,0,12,14,-1
"693","Raheem Sterling",5,26,"1994","12","08","2019/2020","Forward","Manchester City",2659,1214,1445,"England",33,16,17,20,6,14,1,0,1,0,2,13,7,6,29,10,19,5,0,5,249,-1
"694","Raheem Sterling",5,26,"1994","12","08","2020/2021","Forward","Manchester City",2537,1250,1287,"England",31,15,16,10,4,6,7,4,3,0,1,16,8,8,20,12,8,4,0,40,28,-1
"695","Raheem Sterling",5,26,"1994","12","08","2021/2022","Forward","Manchester City",553,430,123,"England",11,7,4,2,2,0,0,0,0,0,0,7,5,2,3,1,2,0,0,38,171,-1
"696","Richarlison de Andrade",5,23,"1997","05","09","2017/2018","Forward","Watford",2827,1265,1562,"Brazil",38,19,19,5,1,4,4,0,4,0,0,9,5,4,48,23,25,4,0,117,102,-1
"697","Richarlison de Andrade",5,23,"1997","05","10","2018/2019","Forward","Everton",2679,1283,1396,"Brazil",35,17,18,13,7,6,1,1,0,0,0,14,9,5,32,15,17,6,1,28,250,-1
"698","Richarlison de Andrade",5,23,"1997","05","10","2019/2020","Forward","Everton",3081,1521,1560,"Brazil",36,18,18,13,7,6,3,1,2,0,0,9,6,3,47,18,29,8,0,41,143,-1
"699","Richarlison de Andrade",5,24,"1997","05","10","2020/2021","Forward","Everton",2872,1555,1317,"Brazil",34,18,16,7,3,4,3,2,1,1,0,11,3,8,37,22,15,5,1,78,142,-1
"700","Richarlison de Andrade",5,24,"1997","05","10","2021/2022","Forward","Everton",650,290,360,"Brazil",8,4,4,2,2,0,1,1,0,0,0,2,1,1,12,5,7,5,0,51,91,-1
"701","Riyad Mahrez",5,30,"1991","02","21","2017/2018","Midfielder","Leicester City",2960,1543,1417,"Algeria",36,18,18,12,6,6,10,4,6,0,0,9,6,3,48,18,30,2,0,37,18,-1
"702","Riyad Mahrez",5,30,"1991","02","21","2018/2019","Midfielder","Manchester City",1339,647,692,"Algeria",27,14,13,7,1,6,4,2,2,0,1,13,6,7,9,4,5,0,0,22,32,-1
"703","Riyad Mahrez",5,30,"1991","02","21","2019/2020","Midfielder","Manchester City",1941,942,999,"Algeria",33,16,17,11,7,4,9,4,5,1,0,14,8,6,12,4,8,0,0,20,8,-1
"704","Riyad Mahrez",5,30,"1991","02","21","2020/2021","Midfielder","Manchester City",1955,852,1103,"Algeria",27,12,15,9,7,2,6,3,3,0,0,14,7,7,21,11,10,0,0,31,15,-1
"705","Riyad Mahrez",5,30,"1991","02","21","2021/2022","Midfielder","Manchester City",382,291,91,"Algeria",10,7,3,2,1,1,1,1,0,0,0,6,5,1,2,1,1,0,0,20,37,-1
"706","Rob Holding",5,25,"1995","09","19","2017/2018","Defender","Arsenal",820,365,455,"England",12,6,6,0,0,0,0,0,0,0,0,3,2,1,15,5,10,3,0,329,273,163
"707","Rob Holding",5,25,"1995","09","20","2018/2019","Defender","Arsenal",807,501,306,"England",10,6,4,0,0,0,0,0,0,0,0,2,2,0,10,5,5,1,0,389,411,47
"708","Rob Holding",5,25,"1995","09","20","2019/2020","Defender","Arsenal",580,224,356,"England",8,3,5,0,0,0,0,0,0,0,0,2,1,1,8,3,5,1,0,256,322,74
"709","Rob Holding",5,26,"1995","09","20","2020/2021","Defender","Arsenal",2557,1297,1260,"England",30,16,14,0,0,0,1,0,1,0,0,11,4,7,26,14,12,2,0,347,215,26
"710","Rob Holding",5,26,"1995","09","20","2021/2022","Defender","Arsenal",180,90,90,"England",2,1,1,0,0,0,0,0,0,0,0,0,0,0,7,2,5,1,0,-1,-1,-1
"711","Roberto Firmino",5,29,"1991","10","01","2017/2018","Forward","Liverpool",2778,1456,1322,"Brazil",37,18,19,15,8,7,7,3,4,1,0,17,12,5,30,7,23,1,0,21,45,-1
"712","Roberto Firmino",5,29,"1991","10","02","2018/2019","Forward","Liverpool",2620,1347,1273,"Brazil",34,16,18,12,7,5,6,3,3,1,0,18,9,9,13,7,6,0,0,32,62,-1
"713","Roberto Firmino",5,29,"1991","10","02","2019/2020","Forward","Liverpool",3003,1462,1541,"Brazil",38,19,19,9,1,8,8,6,2,0,0,15,7,8,26,11,15,0,0,59,34,-1
"714","Roberto Firmino",5,30,"1991","10","02","2020/2021","Forward","Liverpool",2852,1409,1443,"Brazil",36,18,18,9,3,6,7,2,5,0,0,11,5,6,37,18,19,2,0,58,40,-1
"715","Roberto Firmino",5,30,"1991","10","02","2021/2022","Forward","Liverpool",369,152,217,"Brazil",8,4,4,4,0,4,1,0,1,0,0,4,1,3,6,5,1,0,0,2,38,-1
"716","Ross Barkley",5,27,"1993","12","05","2017/2018","Midfielder","Chelsea",131,54,77,"England",2,1,1,0,0,0,0,0,0,0,0,0,0,0,4,1,3,0,0,-1,-1,-1
"717","Ross Barkley",5,27,"1993","12","05","2018/2019","Midfielder","Chelsea",1241,432,809,"England",27,11,16,3,1,2,5,2,3,0,0,11,5,6,13,5,8,1,0,84,12,-1
"718","Ross Barkley",5,27,"1993","12","05","2019/2020","Midfielder","Chelsea",1104,640,464,"England",21,11,10,1,1,0,4,4,0,0,0,7,7,0,13,3,10,0,0,177,18,-1
"719","Ross Barkley",5,27,"1993","12","05","2020/2021","Midfielder","Aston Villa",1577,893,684,"England",26,15,11,3,1,2,1,0,1,0,0,8,4,4,22,18,4,0,0,107,186,-1
"720","Ross Barkley",5,27,"1993","12","05","2021/2022","Midfielder","Chelsea",126,100,26,"England",4,3,1,0,0,0,0,0,0,0,0,2,1,1,0,0,0,0,0,-1,-1,-1
"721","Ruben Loftus-Cheek",5,25,"1996","01","23","2017/2018","Midfielder","Crystal Palace",1875,961,914,"England",24,12,12,2,2,0,3,1,2,0,0,7,2,5,30,18,12,1,0,148,89,-1
"722","Ruben Loftus-Cheek",5,25,"1996","01","23","2018/2019","Midfielder","Chelsea",983,507,476,"England",24,12,12,6,3,3,2,2,0,0,0,12,9,3,8,2,6,0,0,11,83,-1
"723","Ruben Loftus-Cheek",5,25,"1996","01","23","2019/2020","Midfielder","Chelsea",205,86,119,"England",7,3,4,0,0,0,1,0,1,0,0,3,3,0,3,0,3,0,0,-1,-1,-1
"724","Ruben Loftus-Cheek",5,25,"1996","01","23","2020/2021","Midfielder","Fulham",1973,964,1009,"England",31,15,16,1,1,0,0,0,0,0,0,8,4,4,20,11,9,3,0,215,369,-1
"725","Ruben Loftus-Cheek",5,25,"1996","01","23","2021/2022","Midfielder","Chelsea",359,230,129,"England",8,5,3,0,0,0,2,2,0,0,0,4,1,3,3,3,0,0,0,165,7,-1
"726","Ryan Bertrand",5,31,"1989","08","04","2017/2018","Defender","Southampton",3137,1607,1530,"England",35,18,17,0,0,0,4,4,0,0,0,7,3,4,46,24,22,2,0,318,121,87
"727","Ryan Bertrand",5,31,"1989","08","05","2018/2019","Defender","Southampton",2160,1170,990,"England",24,13,11,1,1,0,0,0,0,0,0,6,3,3,36,15,21,8,0,245,366,117
"728","Ryan Bertrand",5,31,"1989","08","05","2019/2020","Defender","Southampton",2743,1303,1440,"England",32,16,16,1,1,0,1,0,1,0,0,7,3,4,41,20,21,4,1,242,243,103
"729","Ryan Bertrand",5,32,"1989","08","05","2020/2021","Defender","Southampton",2599,1170,1429,"England",29,13,16,0,0,0,1,0,1,0,0,8,5,3,47,16,31,5,0,355,231,132
"730","Ryan Bertrand",5,32,"1989","08","05","2021/2022","Defender","Leicester City",338,180,158,"England",4,2,2,0,0,0,0,0,0,0,0,0,0,0,7,3,4,1,0,169,193,109
"731","Ryan Fraser",5,27,"1994","02","24","2017/2018","Midfielder","AFC Bournemouth",2009,989,1020,"Scotland",26,14,12,5,4,1,3,2,1,0,0,3,2,1,36,15,21,0,0,77,104,-1
"732","Ryan Fraser",5,27,"1994","02","24","2018/2019","Midfielder","AFC Bournemouth",3173,1605,1568,"Scotland",38,19,19,7,5,2,14,5,9,0,0,10,6,4,61,23,38,2,0,95,9,-1
"733","Ryan Fraser",5,27,"1994","02","24","2019/2020","Midfielder","AFC Bournemouth",2062,1113,949,"Scotland",28,13,15,1,1,0,4,2,2,0,0,4,2,2,33,17,16,2,0,237,78,-1
"734","Ryan Fraser",5,27,"1994","02","24","2020/2021","Midfielder","Newcastle United",925,408,517,"Scotland",18,9,9,0,0,0,2,1,1,0,0,2,0,2,14,7,7,2,1,325,58,-1
"735","Ryan Fraser",5,27,"1994","02","24","2021/2022","Midfielder","Newcastle United",319,163,156,"Scotland",10,7,3,0,0,0,1,1,0,0,0,0,0,0,4,1,3,0,0,149,25,-1
"736","Sadio Mané",5,28,"1992","04","09","2017/2018","Forward","Liverpool",2207,1034,1173,"Senegal",29,14,15,10,6,4,7,3,4,0,0,12,8,4,18,5,13,4,1,30,20,-1
"737","Sadio Mané",5,28,"1992","04","10","2018/2019","Forward","Liverpool",3086,1643,1443,"Senegal",36,19,17,22,18,4,1,0,1,0,0,20,12,8,18,8,10,2,0,4,249,-1
"738","Sadio Mané",5,29,"1992","04","10","2019/2020","Forward","Liverpool",2755,1505,1250,"Senegal",35,18,17,18,11,7,7,4,3,0,0,12,6,6,27,14,13,3,0,13,41,-1
"739","Sadio Mané",5,29,"1992","04","10","2020/2021","Forward","Liverpool",2812,1472,1340,"Senegal",35,18,17,11,5,6,7,1,6,0,0,12,5,7,26,16,10,3,0,39,39,-1
"740","Sadio Mané",5,29,"1992","04","10","2021/2022","Forward","Liverpool",1094,630,464,"Senegal",13,7,6,7,5,2,1,1,0,0,0,8,4,4,11,5,6,1,0,8,136,-1
"741","Scott McTominay",5,24,"1996","12","08","2017/2018","Midfielder","Manchester United",629,457,172,"England",13,7,6,0,0,0,0,0,0,0,0,6,5,1,3,2,1,2,0,242,302,-1
"742","Scott McTominay",5,24,"1996","12","08","2018/2019","Midfielder","Manchester United",861,345,516,"England",16,7,9,2,0,2,0,0,0,0,0,3,1,2,17,6,11,1,0,91,303,-1
"743","Scott McTominay",5,24,"1996","12","08","2019/2020","Midfielder","Manchester United",1772,800,972,"England",27,13,14,4,3,1,1,0,1,0,0,9,5,4,19,7,12,2,0,91,219,-1
"744","Scott McTominay",5,24,"1996","12","08","2020/2021","Midfielder","Manchester United",2125,1076,1049,"England",32,16,16,4,4,0,1,1,0,0,0,13,6,7,23,15,8,3,0,100,222,-1
"745","Scott McTominay",5,24,"1996","12","08","2021/2022","Midfielder","Manchester United",761,421,340,"England",11,5,6,0,0,0,0,0,0,0,0,1,0,1,14,9,5,2,0,248,253,-1
"746","Sead Kolašinac",5,27,"1993","06","19","2017/2018","Defender","Arsenal",2151,1106,1045,"Bosnia and Herzegovina",27,14,13,2,2,0,4,4,0,0,0,10,7,3,27,13,14,3,0,167,70,61
"747","Sead Kolašinac",5,27,"1993","06","20","2018/2019","Defender","Arsenal",1891,1127,764,"Bosnia and Herzegovina",24,14,10,0,0,0,5,3,2,0,0,5,5,0,26,10,16,5,0,285,45,75
"748","Sead Kolašinac",5,27,"1993","06","20","2019/2020","Defender","Arsenal",1699,724,975,"Bosnia and Herzegovina",26,14,12,0,0,0,2,0,2,0,0,5,3,2,24,10,14,4,0,275,127,82
"749","Sead Kolašinac",5,28,"1993","06","20","2020/2021","Defender","Arsenal",90,90,0,"Bosnia and Herzegovina",1,1,0,0,0,0,0,0,0,0,0,0,0,0,1,1,0,0,0,-1,-1,-1
"750","Sead Kolašinac",5,28,"1993","06","20","2021/2022","Defender","Arsenal",90,0,90,"Bosnia and Herzegovina",2,0,2,0,0,0,0,0,0,0,0,1,0,1,5,0,5,1,0,-1,-1,-1
"751","Séamus Coleman",5,32,"1988","10","10","2017/2018","Defender","Everton",1036,586,450,"Republic of Ireland",12,7,5,0,0,0,1,0,1,0,0,4,3,1,12,5,7,0,0,294,150,53
"752","Séamus Coleman",5,32,"1988","10","11","2018/2019","Defender","Everton",2560,1333,1227,"Republic of Ireland",29,15,14,2,2,0,2,0,2,0,0,13,8,5,29,15,14,1,0,197,178,34
"753","Séamus Coleman",5,32,"1988","10","11","2019/2020","Defender","Everton",1839,1026,813,"Republic of Ireland",27,15,12,0,0,0,1,1,0,0,0,7,4,3,24,12,12,5,1,340,213,60
"754","Séamus Coleman",5,33,"1988","10","11","2020/2021","Defender","Everton",1612,969,643,"Republic of Ireland",25,16,9,0,0,0,3,2,1,0,0,8,1,7,17,16,1,0,0,400,72,33
"755","Séamus Coleman",5,33,"1988","10","11","2021/2022","Defender","Everton",900,450,450,"Republic of Ireland",10,5,5,0,0,0,0,0,0,0,0,2,1,1,15,7,8,2,0,229,234,83
"756","Shane Long",5,34,"1987","01","22","2017/2018","Forward","Southampton",1577,647,930,"Republic of Ireland",30,14,16,2,1,1,1,0,1,0,0,7,2,5,25,10,15,6,0,145,187,-1
"757","Shane Long",5,34,"1987","01","22","2018/2019","Forward","Southampton",1269,629,640,"Republic of Ireland",26,15,11,5,3,2,1,1,0,0,0,5,2,3,20,7,13,3,0,51,182,-1
"758","Shane Long",5,34,"1987","01","22","2019/2020","Forward","Southampton",1397,711,686,"Republic of Ireland",26,13,13,2,2,0,2,1,1,0,0,6,3,3,19,10,9,0,0,125,104,-1
"759","Shane Long",5,34,"1987","01","22","2020/2021","Forward","Southampton",201,68,133,"Republic of Ireland",11,5,6,0,0,0,0,0,0,0,0,4,3,1,2,2,0,0,0,-1,-1,-1
"760","Shane Long",5,34,"1987","01","22","2021/2022","Forward","Southampton",16,16,0,"Republic of Ireland",1,1,0,0,0,0,0,0,0,0,0,0,0,0,0,0,0,0,0,-1,-1,-1
"761","Solomon March",5,26,"1994","07","19","2017/2018","Midfielder","Brighton & Hove Albion",1841,806,1035,"England",36,18,18,1,0,1,1,1,0,0,0,10,5,5,27,10,17,3,0,208,198,-1
"762","Solomon March",5,26,"1994","07","20","2018/2019","Midfielder","Brighton & Hove Albion",2473,1153,1320,"England",35,16,19,1,1,0,5,1,4,0,0,6,4,2,39,13,26,1,0,242,82,-1
"763","Solomon March",5,26,"1994","07","20","2019/2020","Midfielder","Brighton & Hove Albion",1143,566,577,"England",19,9,10,0,0,0,1,1,0,0,0,4,1,3,14,6,8,2,0,409,164,-1
"764","Solomon March",5,27,"1994","07","20","2020/2021","Midfielder","Brighton & Hove Albion",1675,812,863,"England",21,10,11,2,1,1,1,0,1,0,0,6,2,4,24,12,12,0,0,140,201,-1
"765","Solomon March",5,27,"1994","07","20","2021/2022","Midfielder","Brighton & Hove Albion",565,327,238,"England",11,6,5,0,0,0,1,0,1,0,0,5,3,2,9,4,5,1,0,214,81,-1
"766","Theo Walcott",5,32,"1989","03","16","2017/2018","Forward","Everton",1216,650,566,"England",20,11,9,3,3,0,3,1,2,0,0,5,4,1,17,6,11,2,0,81,51,-1
"767","Theo Walcott",5,32,"1989","03","16","2018/2019","Forward","Everton",2122,1114,1008,"England",37,19,18,5,3,2,2,2,0,0,0,13,9,4,33,18,15,1,0,90,170,-1
"768","Theo Walcott",5,32,"1989","03","16","2019/2020","Forward","Everton",1295,696,599,"England",25,14,11,2,1,1,3,3,0,0,0,5,4,1,18,8,10,1,0,120,47,-1
"769","Theo Walcott",5,32,"1989","03","16","2020/2021","Forward","Southampton",1641,850,791,"England",22,12,10,3,1,2,3,2,1,0,0,5,4,1,23,10,13,0,0,109,84,-1
"770","Theo Walcott",5,32,"1989","03","16","2021/2022","Forward","Southampton",283,129,154,"England",6,3,3,0,0,0,0,0,0,0,0,1,1,0,6,2,4,0,0,301,303,-1
"771","Tom Davies",5,22,"1998","06","29","2017/2018","Midfielder","Everton",1899,1089,810,"England",33,18,15,2,2,0,1,1,0,0,0,10,7,3,21,9,12,7,0,164,203,-1
"772","Tom Davies",5,22,"1998","06","30","2018/2019","Midfielder","Everton",975,520,455,"England",16,8,8,0,0,0,0,0,0,0,0,5,3,2,18,12,6,3,0,416,380,-1
"773","Tom Davies",5,22,"1998","06","30","2019/2020","Midfielder","Everton",2027,953,1074,"England",30,16,14,1,0,1,0,0,0,0,0,8,5,3,29,8,21,8,0,231,372,-1
"774","Tom Davies",5,23,"1998","06","30","2020/2021","Midfielder","Everton",1424,798,626,"England",25,12,13,0,0,0,1,1,0,0,0,8,2,6,22,12,10,3,0,404,195,-1
"775","Tom Davies",5,23,"1998","06","30","2021/2022","Midfielder","Everton",154,127,27,"England",5,3,2,1,1,0,0,0,0,0,0,2,2,0,4,4,0,0,0,-1,-1,-1
"776","Tom Heaton",5,34,"1986","04","14","2017/2018","Goalkeeper","Burnley",306,126,180,"England",4,2,2,0,0,0,0,0,0,0,0,1,1,0,4,1,3,0,0,341,251,66
"777","Tom Heaton",5,34,"1986","04","15","2018/2019","Goalkeeper","Burnley",1710,900,810,"England",19,10,9,0,0,0,0,0,0,0,0,4,3,1,23,10,13,3,0,382,354,68
"778","Tom Heaton",5,35,"1986","04","15","2019/2020","Goalkeeper","Aston Villa",1795,900,895,"England",20,10,10,0,0,0,0,0,0,0,0,4,4,0,33,13,20,0,0,418,279,134
"779","Tom Heaton",5,35,"1986","04","15","2020/2021","Goalkeeper","Aston Villa",0,0,0,"England",0,0,0,0,0,0,0,0,0,0,0,0,0,0,0,0,0,0,0,-1,-1,-1
"780","Tom Heaton",5,35,"1986","04","15","2021/2022","Goalkeeper","Manchester United",0,0,0,"England",0,0,0,0,0,0,0,0,0,0,0,0,0,0,0,0,0,0,0,-1,-1,-1
"781","Trent Alexander-Arnold",5,22,"1998","10","06","2017/2018","Defender","Liverpool",1576,865,711,"England",19,10,9,1,1,0,1,1,0,0,0,9,7,2,15,3,12,3,0,202,180,31
"782","Trent Alexander-Arnold",5,22,"1998","10","07","2018/2019","Defender","Liverpool",2467,1266,1201,"England",29,15,14,1,0,1,12,8,4,0,0,16,11,5,14,4,10,3,0,233,6,6
"783","Trent Alexander-Arnold",5,22,"1998","10","07","2019/2020","Defender","Liverpool",3176,1618,1558,"England",38,19,19,4,2,2,13,9,4,0,0,15,7,8,31,15,16,5,0,139,11,24
"784","Trent Alexander-Arnold",5,23,"1998","10","07","2020/2021","Defender","Liverpool",3033,1475,1558,"England",36,18,18,2,1,1,7,1,6,0,0,11,4,7,39,18,21,2,0,207,47,69
"785","Trent Alexander-Arnold",5,23,"1998","10","07","2021/2022","Defender","Liverpool",964,450,514,"England",11,5,6,1,0,1,7,4,3,0,0,7,3,4,9,3,6,1,0,126,2,29
"786","Tyrone Mings",5,28,"1993","03","13","2017/2018","Defender","AFC Bournemouth",202,90,112,"England",4,2,2,0,0,0,0,0,0,0,0,1,1,0,4,1,3,1,0,-1,-1,-1
"787","Tyrone Mings",5,28,"1993","03","13","2018/2019","Defender","AFC Bournemouth",141,7,134,"England",5,2,3,0,0,0,0,0,0,0,0,0,0,0,4,0,4,0,0,-1,-1,-1
"788","Tyrone Mings",5,28,"1993","03","13","2019/2020","Defender","Aston Villa",2903,1373,1530,"England",33,16,17,2,1,1,2,1,1,0,0,6,6,0,50,20,30,7,0,209,207,125
"789","Tyrone Mings",5,28,"1993","03","13","2020/2021","Defender","Aston Villa",3195,1665,1530,"England",36,19,17,2,1,1,2,2,0,0,0,15,7,8,39,27,12,6,1,205,191,52
"790","Tyrone Mings",5,28,"1993","03","13","2021/2022","Defender","Aston Villa",1028,398,630,"England",12,5,7,1,1,0,1,1,0,0,0,4,3,1,15,4,11,4,0,129,118,69
"791","Victor Nilsson Lindelöf",5,26,"1994","07","16","2017/2018","Defender","Manchester United",1281,674,607,"Sweden",17,8,9,0,0,0,0,0,0,0,0,6,3,3,13,5,8,1,0,243,380,44
"792","Victor Nilsson Lindelöf",5,26,"1994","07","17","2018/2019","Defender","Manchester United",2602,1112,1490,"Sweden",30,13,17,1,1,0,1,0,1,0,0,6,2,4,38,13,25,1,0,263,246,88
"793","Victor Nilsson Lindelöf",5,26,"1994","07","17","2019/2020","Defender","Manchester United",3094,1576,1518,"Sweden",35,18,17,1,1,0,0,0,0,0,0,12,7,5,28,12,16,6,0,243,340,15
"794","Victor Nilsson Lindelöf",5,27,"1994","07","17","2020/2021","Defender","Manchester United",2586,1260,1326,"Sweden",29,14,15,1,1,0,1,0,1,0,0,10,5,5,27,15,12,0,0,262,227,30
"795","Victor Nilsson Lindelöf",5,27,"1994","07","17","2021/2022","Defender","Manchester United",834,384,450,"Sweden",10,5,5,0,0,0,2,1,1,0,0,1,0,1,17,10,7,1,0,243,55,107
"796","Virgil van Dijk",5,29,"1991","07","07","2017/2018","Defender","Liverpool",2253,1170,1083,"Netherlands",26,13,13,0,0,0,0,0,0,0,0,9,6,3,26,11,15,1,0,292,312,54
"797","Virgil van Dijk",5,29,"1991","07","08","2018/2019","Defender","Liverpool",3385,1675,1710,"Netherlands",38,19,19,4,2,2,2,1,1,0,0,21,12,9,19,8,11,1,0,152,201,5
"798","Virgil van Dijk",5,29,"1991","07","08","2019/2020","Defender","Liverpool",3420,1710,1710,"Netherlands",38,19,19,5,4,1,1,1,0,0,0,15,7,8,33,16,17,1,0,123,258,23
"799","Virgil van Dijk",5,30,"1991","07","08","2020/2021","Defender","Liverpool",371,180,191,"Netherlands",5,2,3,1,1,0,0,0,0,0,0,1,0,1,11,4,7,1,0,68,351,161
"800","Virgil van Dijk",5,30,"1991","07","08","2021/2022","Defender","Liverpool",1170,630,540,"Netherlands",13,7,6,1,1,0,1,1,0,0,0,8,4,4,11,5,6,0,0,134,137,30
"801","Wayne Hennessey",5,34,"1987","01","24","2017/2018","Goalkeeper","Crystal Palace",2430,1170,1260,"Wales",27,13,14,0,0,0,0,0,0,0,0,7,4,3,40,15,25,1,0,393,363,131
"802","Wayne Hennessey",5,34,"1987","01","24","2018/2019","Goalkeeper","Crystal Palace",1575,675,900,"Wales",18,8,10,0,0,0,0,0,0,0,0,5,2,3,23,8,15,0,0,321,404,87
"803","Wayne Hennessey",5,34,"1987","01","24","2019/2020","Goalkeeper","Crystal Palace",270,90,180,"Wales",3,1,2,0,0,0,0,0,0,0,0,0,0,0,8,2,6,0,0,-1,-1,-1
"804","Wayne Hennessey",5,34,"1987","01","24","2020/2021","Goalkeeper","Crystal Palace",0,0,0,"Wales",0,0,0,0,0,0,0,0,0,0,0,0,0,0,0,0,0,0,0,-1,-1,-1
"805","Wayne Hennessey",5,34,"1987","01","24","2021/2022","Goalkeeper","Burnley",0,0,0,"Wales",0,0,0,0,0,0,0,0,0,0,0,0,0,0,0,0,0,0,0,-1,-1,-1
"806","Wilfried Zaha",5,28,"1992","11","10","2017/2018","Midfielder","Crystal Palace",2550,1350,1200,"Côte d'Ivoire",29,15,14,9,7,2,3,2,1,0,0,9,4,5,31,20,11,5,0,49,119,-1
"807","Wilfried Zaha",5,28,"1992","11","10","2018/2019","Midfielder","Crystal Palace",3041,1347,1694,"Côte d'Ivoire",34,15,19,10,1,9,5,3,2,0,0,10,5,5,45,18,27,10,1,63,92,-1
"808","Wilfried Zaha",5,28,"1992","11","10","2019/2020","Midfielder","Crystal Palace",3280,1645,1635,"Côte d'Ivoire",38,19,19,4,3,1,3,1,2,0,0,10,6,4,44,19,25,5,0,142,163,-1
"809","Wilfried Zaha",5,28,"1992","11","10","2020/2021","Midfielder","Crystal Palace",2613,1350,1263,"Côte d'Ivoire",30,15,15,11,5,6,2,1,1,2,0,6,4,2,48,24,24,6,0,35,179,-1
"810","Wilfried Zaha",5,28,"1992","11","10","2021/2022","Midfielder","Crystal Palace",1085,545,540,"Côte d'Ivoire",13,7,6,4,3,1,1,1,0,2,0,4,3,1,14,3,11,3,0,37,142,-1
