"","ime.priimek","starost","leto","mesec","dan","sezona","pozicija","klub","minute.skupno","minute.doma","minute.gostovanje","nacionalnost","nastopi.skupno","nastopi.doma","nastopi.gostovanje","goli.skupno","goli.doma","goli.gostovanje","asistence.skupno","asistence.doma","asistence.gostovanje","penal.zadet","penal.zgresen","nedotaknjena.mreza.skupno","nedotaknjena.mreza.doma","nedotaknjena.mreza.gostovanje","prejeti.zadetki.skupno","prejeti.zadetki.doma","prejeti.zadetki.gostovanje","rumeni.kartoni","rdeci.kartoni","rank.napadalci","rank.vezisti","rank.branilci"
"1","Aaron Cresswell",31,"1989","12","15","2017/2018","Defender","West Ham United",3073,1604,1469,"England",36,18,18,1,1,0,7,3,4,0,0,10,7,3,57,23,34,7,0,233,55,164
"2","Aaron Lennon",33,"1987","04","15","2017/2018","Midfielder","Burnley",1918,927,991,"England",29,13,16,0,0,0,2,0,2,0,0,7,4,3,28,8,20,2,0,268,144,-1
"3","Aaron Mooy",30,"1990","09","14","2017/2018","Midfielder","Huddersfield Town",3070,1635,1435,"Australia",36,19,17,4,2,2,3,2,1,1,0,10,7,3,51,24,27,5,0,136,141,-1
"4","Aaron Ramsdale",22,"1998","05","13","2017/2018","Goalkeeper","AFC Bournemouth",0,0,0,"England",0,0,0,0,0,0,0,0,0,0,0,0,0,0,0,0,0,0,0,-1,-1,-1
"5","Aaron Ramsey",30,"1990","12","26","2017/2018","Midfielder","Arsenal",1848,976,872,"Wales",24,13,11,7,6,1,8,5,3,0,0,10,7,3,22,9,13,0,0,44,8,-1
"6","Aaron Wan-Bissaka",23,"1997","11","26","2017/2018","Midfielder","Crystal Palace",628,358,270,"England",7,4,3,0,0,0,0,0,0,0,0,2,1,1,9,5,4,1,0,260,303,-1
"7","Abdelhamid Sabiri",24,"1996","11","28","2017/2018","Midfielder","Huddersfield Town",219,82,137,"Morocco",5,1,4,0,0,0,1,1,0,0,0,1,0,1,5,1,4,1,0,-1,-1,-1
"8","Abdoulaye Doucouré",28,"1993","01","01","2017/2018","Midfielder","Watford",3325,1705,1620,"France",37,19,18,7,4,3,3,3,0,0,0,9,5,4,56,29,27,10,0,101,155,-1
"9","Adam David Lallana",32,"1988","05","09","2017/2018","Midfielder","Liverpool",235,64,171,"England",12,6,6,0,0,0,0,0,0,0,0,5,3,2,0,0,0,1,0,-1,-1,-1
"10","Adam Legzdins",34,"1986","11","28","2017/2018","Goalkeeper","Burnley",0,0,0,"England",0,0,0,0,0,0,0,0,0,0,0,0,0,0,0,0,0,0,0,-1,-1,-1
"11","Adam Smith",29,"1991","04","28","2017/2018","Defender","AFC Bournemouth",2068,1138,930,"England",27,14,13,1,1,0,3,2,1,0,0,4,2,2,34,19,15,6,0,230,100,132
"12","Ademola Lookman",23,"1997","10","19","2017/2018","Forward","Everton",154,82,72,"England",7,5,2,0,0,0,1,1,0,0,0,2,2,0,4,1,3,0,0,-1,-1,-1
"13","Adrian Mariappa",34,"1986","10","02","2017/2018","Defender","Watford",2209,1020,1189,"Jamaica",28,13,15,0,0,0,0,0,0,0,0,7,4,3,39,18,21,4,0,276,272,151
"14","Adrián San Miguel del Castillo",34,"1987","01","03","2017/2018","Goalkeeper","West Ham United",1710,900,810,"Spain",19,10,9,0,0,0,0,0,0,0,0,6,4,2,28,11,17,2,0,256,377,124
"15","Adrien Sebastian Perruchet Silva",32,"1989","03","15","2017/2018","Midfielder","Leicester City",762,492,270,"Portugal",12,8,4,0,0,0,1,1,0,0,0,3,3,0,17,7,10,3,0,261,115,-1
"16","Ahmed Hegazi",30,"1991","01","25","2017/2018","Defender","West Bromwich Albion",3387,1710,1677,"Egypt",38,19,19,2,2,0,0,0,0,0,0,10,6,4,51,27,24,4,0,222,323,93
"17","Ahmed Musa",28,"1992","10","13","2017/2018","Forward","Leicester City",0,0,0,"Nigeria",0,0,0,0,0,0,0,0,0,0,0,0,0,0,0,0,0,0,0,-1,-1,-1
"18","Aiden O'Neill",22,"1998","07","03","2017/2018","Midfielder","Burnley",0,0,0,"Australia",0,0,0,0,0,0,0,0,0,0,0,0,0,0,0,0,0,0,0,-1,-1,-1
"19","Ainsley Maitland-Niles",23,"1997","08","28","2017/2018","Midfielder","Arsenal",907,461,446,"England",15,7,8,0,0,0,0,0,0,0,0,5,3,2,14,7,7,1,0,286,289,-1
"20","Alberto Moreno",28,"1992","07","04","2017/2018","Defender","Liverpool",1264,543,721,"Spain",16,7,9,0,0,0,0,0,0,0,0,6,5,1,17,1,16,1,0,347,304,69
"21","Aleksandar Dragović",30,"1991","03","06","2017/2018","Defender","Leicester City",766,384,382,"Austria",11,6,5,0,0,0,0,0,0,0,0,4,3,1,12,2,10,2,0,289,292,111
"22","Aleksandar Mitrović",26,"1994","09","15","2017/2018","Forward","Newcastle United",89,53,36,"Serbia",6,4,2,1,1,0,0,0,0,0,0,2,2,0,0,0,0,0,0,-1,-1,-1
"23","Alex Iwobi",24,"1996","05","02","2017/2018","Forward","Arsenal",1843,790,1053,"Nigeria",26,11,15,3,3,0,5,4,1,0,0,9,5,4,24,9,15,1,0,122,40,-1
"24","Alex McCarthy",31,"1989","12","03","2017/2018","Goalkeeper","Southampton",1620,720,900,"England",18,8,10,0,0,0,0,0,0,0,0,4,1,3,23,10,13,2,0,283,384,77
"25","Alex Oxlade-Chamberlain",27,"1993","08","14","2017/2018","Midfielder","Liverpool",1726,835,891,"England",35,16,19,3,2,1,7,5,2,0,0,13,8,5,24,9,15,3,0,114,10,-1
"26","Alex Palmer",24,"1996","08","09","2017/2018","Goalkeeper","West Bromwich Albion",0,0,0,"England",0,0,0,0,0,0,0,0,0,0,0,0,0,0,0,0,0,0,0,-1,-1,-1
"27","Alex Pritchard",27,"1993","05","02","2017/2018","Midfielder","Huddersfield Town",1002,521,481,"England",14,7,7,1,1,0,1,0,1,0,0,3,2,1,12,6,6,1,0,156,149,-1
"28","Alexander Sørloth",25,"1995","12","05","2017/2018","Forward","Crystal Palace",360,180,180,"Norway",4,2,2,0,0,0,0,0,0,0,0,0,0,0,8,3,5,0,0,245,270,-1
"29","Alexandre Lacazette",29,"1991","05","27","2017/2018","Forward","Arsenal",2212,1152,1060,"France",32,16,16,14,11,3,4,3,1,2,0,12,8,4,28,14,14,1,0,13,77,-1
"30","Alexis Sanchez",32,"1988","12","19","2017/2018","Forward","Manchester United",2555,1405,1150,"Chile",31,17,14,9,5,4,6,2,4,1,1,13,9,4,31,13,18,5,0,50,56,-1
"31","Alfie Mawson",27,"1994","01","19","2017/2018","Defender","Swansea City",3420,1710,1710,"England",38,19,19,2,2,0,1,1,0,0,0,9,5,4,53,23,30,3,0,221,229,103
"32","Alfie Whiteman",22,"1998","10","01","2017/2018","Goalkeeper","Tottenham Hotspur",0,0,0,"England",0,0,0,0,0,0,0,0,0,0,0,0,0,0,0,0,0,0,0,-1,-1,-1
"33","Ali Gabr",32,"1989","01","10","2017/2018","Defender","West Bromwich Albion",0,0,0,"Egypt",0,0,0,0,0,0,0,0,0,0,0,0,0,0,0,0,0,0,0,-1,-1,-1
"34","Allan Nyom",32,"1988","05","09","2017/2018","Defender","West Bromwich Albion",2308,1096,1212,"Cameroon",29,15,14,0,0,0,1,1,0,0,0,9,5,4,38,20,18,7,0,385,211,130
"35","Alvaro Morata",28,"1992","10","22","2017/2018","Forward","Chelsea",2066,1127,939,"Spain",31,17,14,11,6,5,6,4,2,0,0,13,9,4,17,8,9,7,0,22,30,-1
"36","Ander Herrera",31,"1989","08","13","2017/2018","Midfielder","Manchester United",1261,361,900,"Spain",26,10,16,0,0,0,2,0,2,0,0,13,6,7,13,3,10,5,0,378,93,-1
"37","Anders Lindegaard",36,"1984","04","12","2017/2018","Goalkeeper","Burnley",0,0,0,"Denmark",0,0,0,0,0,0,0,0,0,0,0,0,0,0,0,0,0,0,0,-1,-1,-1
"38","Andre Ayew",31,"1989","12","17","2017/2018","Forward","Swansea City",1842,842,1000,"Ghana",30,14,16,3,2,1,4,4,0,0,1,6,4,2,38,13,25,5,0,123,58,-1
"39","Andre Gray",29,"1991","06","25","2017/2018","Forward","Watford",1495,646,849,"England",31,14,17,5,2,3,2,1,1,0,0,7,3,4,24,13,11,1,0,54,116,-1
"40","André Martín Carrillo Díaz",29,"1991","06","13","2017/2018","Forward","Watford",1536,747,789,"Peru",28,15,13,1,1,0,2,1,1,0,0,7,4,3,28,15,13,2,0,191,109,-1
"41","Andreas Christensen",24,"1996","04","09","2017/2018","Defender","Chelsea",2071,943,1128,"Denmark",27,14,13,0,0,0,0,0,0,0,0,11,7,4,21,9,12,0,0,353,260,43
"42","Andrew Robertson",27,"1994","03","11","2017/2018","Defender","Liverpool",1943,1155,788,"Scotland",22,13,9,1,1,0,5,3,2,0,0,10,7,3,16,7,9,2,0,211,47,19
"43","Andrew Surman",34,"1986","08","19","2017/2018","Midfielder","AFC Bournemouth",1852,985,867,"England",25,12,13,2,1,1,5,3,2,0,0,5,3,2,26,14,12,2,0,147,41,-1
"44","Andros Townsend",29,"1991","07","15","2017/2018","Midfielder","Crystal Palace",3128,1527,1601,"England",36,18,18,2,2,0,7,3,4,0,0,8,3,5,47,23,24,3,0,198,62,-1
"45","Andy Carroll",32,"1989","01","06","2017/2018","Forward","West Ham United",745,517,228,"England",16,9,7,3,3,0,0,0,0,0,0,5,3,2,11,8,3,7,1,38,313,-1
"46","Andy King",32,"1988","10","29","2017/2018","Midfielder","Swansea City",1251,516,735,"Wales",22,10,12,3,2,1,0,0,0,0,0,3,1,2,25,10,15,2,0,76,299,-1
"47","Àngel Rangel Zaragoza",38,"1982","10","28","2017/2018","Defender","Swansea City",155,153,2,"Spain",4,3,1,0,0,0,0,0,0,0,0,1,0,1,3,3,0,0,0,-1,-1,-1
"48","Angelo Ogbonna",32,"1988","05","22","2017/2018","Defender","West Ham United",2880,1440,1440,"Italy",32,16,16,1,0,1,0,0,0,0,0,7,5,2,56,23,33,3,0,238,390,167
"49","Anthony Knockaert",29,"1991","11","20","2017/2018","Midfielder","Brighton & Hove Albion",2425,1286,1139,"France",33,16,17,3,3,0,1,0,1,0,0,10,5,5,28,12,16,5,1,146,213,-1
"50","Anthony Martial",25,"1995","12","05","2017/2018","Forward","Manchester United",1583,670,913,"France",30,15,15,9,5,4,5,4,1,1,0,15,10,5,13,5,8,1,0,18,22,-1
"51","Antonio Martínez López",23,"1997","06","29","2017/2018","Forward","West Ham United",0,0,0,"Spain",0,0,0,0,0,0,0,0,0,0,0,0,0,0,0,0,0,0,0,-1,-1,-1
"52","Antonio Rüdiger",28,"1993","03","03","2017/2018","Defender","Chelsea",2336,1346,990,"Germany",27,16,11,2,2,0,1,0,1,0,0,13,8,5,21,15,6,4,0,174,216,26
"53","Antonio Valencia",35,"1985","08","03","2017/2018","Defender","Manchester United",2743,1440,1303,"Ecuador",31,16,15,3,2,1,1,0,1,0,0,15,10,5,22,7,15,7,0,153,230,16
"54","Arthur Masuaku",27,"1993","11","07","2017/2018","Defender","West Ham United",1872,923,949,"France",27,14,13,0,0,0,3,3,0,0,0,7,5,2,27,10,17,5,0,356,96,82
"55","Artur Boruc",41,"1980","02","20","2017/2018","Goalkeeper","AFC Bournemouth",0,0,0,"Poland",0,0,0,0,0,0,0,0,0,0,0,0,0,0,0,0,0,0,0,-1,-1,-1
"56","Ashley Barnes",31,"1989","10","30","2017/2018","Forward","Burnley",2157,1150,1007,"England",36,18,18,9,5,4,0,0,0,0,0,12,7,5,20,9,11,10,0,33,263,-1
"57","Ashley Westwood",30,"1990","03","31","2017/2018","Midfielder","Burnley",1106,553,553,"England",19,9,10,0,0,0,1,1,0,0,0,5,4,1,15,5,10,2,0,302,162,-1
"58","Ashley Williams",36,"1984","08","22","2017/2018","Defender","Everton",1833,903,930,"Wales",24,13,11,1,1,0,0,0,0,0,0,6,4,2,30,11,19,4,1,216,264,129
"59","Ashley Young",35,"1985","07","08","2017/2018","Midfielder","Manchester United",2447,1222,1225,"England",30,15,15,2,0,2,4,4,0,0,0,12,8,4,25,9,16,7,0,184,86,-1
"60","Asmir Begović",33,"1987","06","19","2017/2018","Goalkeeper","AFC Bournemouth",3420,1710,1710,"Bosnia and Herzegovina",38,19,19,0,0,0,0,0,0,0,0,6,3,3,56,28,28,2,0,389,324,125
"61","Axel Tuanzebe",23,"1997","11","14","2017/2018","Defender","Manchester United",0,0,0,"England",1,0,1,0,0,0,0,0,0,0,0,1,0,1,0,0,0,0,0,-1,-1,-1
"62","Aymeric Laporte",26,"1994","05","26","2017/2018","Defender","Manchester City",807,450,357,"France",9,5,4,0,0,0,0,0,0,0,0,4,3,1,5,2,3,1,0,272,262,7
"63","Ayoze Perez",27,"1993","07","28","2017/2018","Forward","Newcastle United",2497,1190,1307,"Spain",36,18,18,8,4,4,5,2,3,0,0,9,7,2,26,8,18,3,0,59,66,-1
"64","Bakary Sako",32,"1988","04","25","2017/2018","Midfielder","Crystal Palace",468,184,284,"Mali",16,6,10,3,2,1,0,0,0,0,0,3,1,2,10,0,10,0,0,12,317,-1
"65","Ben Chilwell",24,"1996","12","21","2017/2018","Defender","Leicester City",1852,899,953,"England",24,12,12,0,0,0,2,0,2,0,0,6,4,2,28,10,18,3,1,339,129,91
"66","Ben Davies",27,"1993","04","23","2017/2018","Defender","Tottenham Hotspur",2323,1062,1261,"Wales",29,14,15,2,0,2,6,2,4,0,0,14,8,6,17,7,10,3,0,175,44,11
"67","Ben Foster",37,"1983","04","02","2017/2018","Goalkeeper","West Bromwich Albion",3330,1710,1620,"England",37,19,18,0,0,0,0,0,0,0,0,10,6,4,51,27,24,2,0,355,335,99
"68","Ben Hamer",33,"1987","11","20","2017/2018","Goalkeeper","Leicester City",274,180,94,"England",4,2,2,0,0,0,0,0,0,0,0,1,1,0,6,2,4,0,0,328,296,171
"69","Ben Mee",31,"1989","09","20","2017/2018","Defender","Burnley",2610,1170,1440,"England",29,13,16,0,0,0,0,0,0,0,0,9,4,5,23,9,14,5,0,313,277,24
"70","Ben Watson",35,"1985","07","08","2017/2018","Midfielder","Watford",458,223,235,"England",8,3,5,0,0,0,0,0,0,0,0,1,0,1,9,4,5,1,0,345,284,-1
"71","Beni Baningime",32,"1988","09","08","2017/2018","Midfielder","Everton",192,125,67,"Congo DR",8,5,3,0,0,0,0,0,0,0,0,4,3,1,2,1,1,1,0,-1,-1,-1
"72","Benik Afobe",28,"1993","02","12","2017/2018","Forward","AFC Bournemouth",532,246,286,"Congo DR",17,9,8,0,0,0,0,0,0,0,0,2,1,1,12,4,8,0,0,392,344,-1
"73","Benjamin Johnson",21,"2000","01","24","2017/2018","Forward","West Ham United",0,0,0,"England",0,0,0,0,0,0,0,0,0,0,0,0,0,0,0,0,0,0,0,-1,-1,-1
"74","Benjamin Mendy",26,"1994","07","16","2017/2018","Defender","Manchester City",361,181,180,"France",7,5,2,0,0,0,1,1,0,0,0,5,4,1,1,0,1,2,0,288,35,3
"75","Benjamin Woodburn",21,"1999","10","14","2017/2018","Forward","Liverpool",6,6,0,"Wales",1,1,0,0,0,0,0,0,0,0,0,1,1,0,0,0,0,0,0,-1,-1,-1
"76","Beram Kayal",32,"1988","05","01","2017/2018","Midfielder","Brighton & Hove Albion",739,233,506,"Israel",19,9,10,0,0,0,0,0,0,0,0,3,2,1,14,4,10,2,0,254,319,-1
"77","Bernardo Silva",26,"1994","08","09","2017/2018","Midfielder","Manchester City",1519,762,757,"Portugal",35,18,17,6,4,2,4,2,2,0,0,17,7,10,9,6,3,0,0,39,39,-1
"78","Bojan",30,"1990","08","27","2017/2018","Forward","Stoke City",72,0,72,"Spain",1,0,1,0,0,0,0,0,0,0,0,0,0,0,1,0,1,0,0,-1,-1,-1
"79","Brad Smith",26,"1994","04","08","2017/2018","Defender","AFC Bournemouth",0,0,0,"Australia",0,0,0,0,0,0,0,0,0,0,0,0,0,0,0,0,0,0,0,-1,-1,-1
"80","Brahim Abdelkader Diaz",21,"1999","08","02","2017/2018","Midfielder","Manchester City",50,22,28,"Spain",5,3,2,0,0,0,0,0,0,0,0,2,1,1,1,0,1,0,0,-1,-1,-1
"81","Bruno Martins Indi",29,"1992","02","08","2017/2018","Defender","Stoke City",1244,534,710,"Netherlands",17,8,9,0,0,0,0,0,0,0,0,3,1,2,26,12,14,3,0,295,322,169
"82","Bruno Saltor Grau",40,"1980","09","30","2017/2018","Defender","Brighton & Hove Albion",2018,1073,945,"Spain",25,14,11,0,0,0,0,0,0,0,0,10,5,5,22,10,12,3,0,410,354,50
"83","Callum Hudson-Odoi",20,"2000","11","07","2017/2018","Midfielder","Chelsea",27,27,0,"England",2,2,0,0,0,0,0,0,0,0,0,0,0,0,1,1,0,0,0,-1,-1,-1
"84","Callum Wilson",29,"1992","02","27","2017/2018","Forward","AFC Bournemouth",1990,1050,940,"England",28,14,14,8,5,3,2,1,1,0,0,5,2,3,30,17,13,0,0,40,147,-1
"85","Calum Chambers",26,"1995","01","20","2017/2018","Defender","Arsenal",869,364,505,"England",12,6,6,0,0,0,0,0,0,0,0,3,3,0,13,4,9,1,0,259,314,90
"86","Cameron Carter-Vickers",23,"1997","12","31","2017/2018","Defender","Tottenham Hotspur",0,0,0,"USA",0,0,0,0,0,0,0,0,0,0,0,0,0,0,0,0,0,0,0,-1,-1,-1
"87","Carl Stewart",23,"1997","05","01","2017/2018","Midfielder","Watford",0,0,0,"England",0,0,0,0,0,0,0,0,0,0,0,0,0,0,0,0,0,0,0,-1,-1,-1
"88","Cedric Soares",29,"1991","08","30","2017/2018","Defender","Southampton",2797,1433,1364,"Portugal",32,16,16,0,0,0,3,0,3,0,0,7,3,4,41,21,20,3,0,319,130,86
"89","Cenk Tosun",29,"1991","06","06","2017/2018","Forward","Everton",991,503,488,"Turkey",14,6,8,5,1,4,0,0,0,0,0,4,3,1,13,5,8,0,0,25,254,-1
"90","Cesar Azpilicueta",31,"1989","08","27","2017/2018","Defender","Chelsea",3330,1620,1710,"Spain",37,18,19,2,2,0,6,3,3,0,0,15,9,6,34,15,19,1,0,220,76,45
"91","Cesc Fabregas",33,"1987","05","03","2017/2018","Midfielder","Chelsea",2309,1432,877,"Spain",32,18,14,2,1,1,4,1,3,0,0,14,9,5,25,14,11,6,1,177,75,-1
"92","Chancel Mbemba Mangulu",26,"1994","08","07","2017/2018","Defender","Newcastle United",672,313,359,"Congo DR",9,4,5,0,0,0,0,0,0,0,0,1,1,0,11,4,7,0,0,366,338,127
"93","Charlie Adam",35,"1985","12","10","2017/2018","Midfielder","Stoke City",408,295,113,"Scotland",11,7,4,0,0,0,0,0,0,0,1,3,2,1,7,3,4,3,1,316,402,-1
"94","Charlie Austin",31,"1989","07","04","2017/2018","Forward","Southampton",1030,581,449,"England",24,14,10,7,5,2,0,0,0,1,0,4,2,2,14,8,6,2,0,10,392,-1
"95","Charlie Daniels",34,"1986","09","06","2017/2018","Defender","AFC Bournemouth",3005,1385,1620,"England",35,17,18,1,1,0,3,1,2,0,0,6,3,3,46,22,24,0,0,232,140,101
"96","Charlie Taylor",27,"1993","09","17","2017/2018","Defender","Burnley",949,409,540,"England",11,5,6,0,0,0,0,0,0,0,0,3,1,2,10,6,4,3,0,301,271,49
"97","Charly Junior Musonda",24,"1996","10","14","2017/2018","Midfielder","Chelsea",34,0,34,"Belgium",3,1,2,0,0,0,1,0,1,0,0,1,0,1,0,0,0,0,0,-1,-1,-1
"98","Cheikhou Kouyaté",31,"1989","12","21","2017/2018","Midfielder","West Ham United",2803,1481,1322,"Senegal",33,17,16,2,2,0,3,1,2,0,0,7,5,2,55,25,30,5,0,194,127,-1
"99","Choupo-Moting",31,"1989","03","23","2017/2018","Forward","Stoke City",2248,1203,1045,"Cameroon",30,15,15,5,4,1,5,5,0,0,0,5,3,2,44,18,26,3,0,94,59,-1
"100","Chris Brunt",36,"1984","12","14","2017/2018","Midfielder","West Bromwich Albion",1923,1157,766,"Northern Ireland",26,15,11,0,0,0,7,6,1,0,0,9,5,4,21,13,8,5,0,388,13,-1
"101","Chris Löwe",31,"1989","04","15","2017/2018","Defender","Huddersfield Town",1593,900,693,"Germany",23,13,10,0,0,0,0,0,0,0,0,7,4,3,25,15,10,1,0,402,381,112
"102","Chris Smalling",31,"1989","11","22","2017/2018","Defender","Manchester United",2535,1170,1365,"England",29,13,16,4,1,3,0,0,0,0,0,12,7,5,23,7,16,4,0,128,409,27
"103","Chris Wood",29,"1991","12","07","2017/2018","Forward","Burnley",1633,807,826,"New Zealand",24,12,12,10,5,5,1,0,1,0,0,9,5,4,10,5,5,1,0,15,183,-1
"104","Christian Atsu Twasam",29,"1992","01","10","2017/2018","Midfielder","Newcastle United",1782,952,830,"Ghana",28,15,13,2,1,1,2,1,1,0,0,8,6,2,22,7,15,1,0,151,134,-1
"105","Christian Benteke",30,"1990","12","03","2017/2018","Forward","Crystal Palace",2236,1184,1052,"Belgium",31,17,14,3,1,2,5,2,3,1,1,9,4,5,35,19,16,6,0,139,61,-1
"106","Christian Eriksen",29,"1992","02","14","2017/2018","Midfielder","Tottenham Hotspur",3226,1696,1530,"Denmark",37,19,18,10,5,5,10,3,7,0,0,16,10,6,30,15,15,0,0,62,24,-1
"107","Christian Fuchs",34,"1986","04","06","2017/2018","Defender","Leicester City",1918,979,939,"Austria",25,11,14,0,0,0,1,1,0,0,0,6,3,3,34,12,22,1,0,333,201,153
"108","Christian Kabasele",30,"1991","02","24","2017/2018","Defender","Watford",2332,1144,1188,"Belgium",28,13,15,2,1,1,0,0,0,0,0,7,3,4,39,22,17,5,0,172,388,140
"109","Christopher Schindler",30,"1990","04","28","2017/2018","Defender","Huddersfield Town",3266,1677,1589,"Germany",37,19,18,0,0,0,1,1,0,0,0,10,7,3,51,24,27,8,1,403,238,113
"110","Chung-Yong Lee",32,"1988","07","01","2017/2018","Midfielder","Crystal Palace",130,56,74,"South Korea",7,5,2,0,0,0,0,0,0,0,0,3,3,0,3,2,1,0,0,-1,-1,-1
"111","Ciaran Clark",31,"1989","09","25","2017/2018","Defender","Newcastle United",1745,845,900,"Republic of Ireland",20,10,10,2,1,1,1,0,1,0,0,4,2,2,29,12,17,3,0,150,197,134
"112","Claudio Andrés Bravo Muñoz",37,"1983","04","12","2017/2018","Goalkeeper","Manchester City",225,135,90,"Chile",3,2,1,0,0,0,0,0,0,0,0,2,1,1,1,1,0,0,0,-1,-1,-1
"113","Claudio Yacob",33,"1987","07","17","2017/2018","Midfielder","West Bromwich Albion",899,435,464,"Argentina",16,8,8,0,0,0,0,0,0,0,0,4,2,2,17,10,7,5,0,387,331,-1
"114","Collin Quaner",29,"1991","06","17","2017/2018","Forward","Huddersfield Town",1272,597,675,"Germany",26,13,13,0,0,0,4,1,3,0,0,7,6,1,22,6,16,4,0,407,23,-1
"115","Connor Goldson",28,"1992","12","18","2017/2018","Defender","Brighton & Hove Albion",199,180,19,"England",3,2,1,0,0,0,0,0,0,0,0,1,1,0,5,4,1,1,0,-1,-1,-1
"116","Connor Mahoney",24,"1997","02","12","2017/2018","Midfielder","AFC Bournemouth",0,0,0,"England",0,0,0,0,0,0,0,0,0,0,0,0,0,0,0,0,0,0,0,-1,-1,-1
"117","Connor Roberts",25,"1995","09","22","2017/2018","Midfielder","Swansea City",268,153,115,"Wales",4,2,2,0,0,0,0,0,0,0,0,0,0,0,4,2,2,0,0,-1,-1,-1
"118","Conor Masterson",22,"1998","09","07","2017/2018","Defender","Liverpool",0,0,0,"Republic of Ireland",0,0,0,0,0,0,0,0,0,0,0,0,0,0,0,0,0,0,0,-1,-1,-1
"119","Costel Pantilimon",34,"1987","02","01","2017/2018","Goalkeeper","Watford",0,0,0,"Romania",0,0,0,0,0,0,0,0,0,0,0,0,0,0,0,0,0,0,0,-1,-1,-1
"120","Craig Cathcart",32,"1989","02","06","2017/2018","Defender","Watford",495,225,270,"Northern Ireland",7,4,3,0,0,0,0,0,0,0,0,2,2,0,4,1,3,1,0,248,279,17
"121","Craig Dawson",30,"1990","05","05","2017/2018","Defender","West Bromwich Albion",2511,1251,1260,"England",28,14,14,2,2,0,0,0,0,0,0,8,5,3,36,16,20,6,0,180,332,78
"122","Curtis Jones",20,"2001","01","30","2017/2018","Midfielder","Liverpool",0,0,0,"England",0,0,0,0,0,0,0,0,0,0,0,0,0,0,0,0,0,0,0,-1,-1,-1
"123","Dale Stephens",31,"1989","06","11","2017/2018","Midfielder","Brighton & Hove Albion",3240,1620,1620,"England",36,18,18,0,0,0,3,2,1,0,0,10,5,5,49,22,27,6,0,384,163,-1
"124","Daley Blind",31,"1990","03","09","2017/2018","Defender","Manchester United",360,257,103,"Netherlands",7,3,4,0,0,0,0,0,0,0,0,7,3,4,0,0,0,0,0,376,398,1
"125","Damien Delaney",39,"1981","07","19","2017/2018","Defender","Crystal Palace",95,5,90,"Republic of Ireland",2,1,1,0,0,0,0,0,0,0,0,0,0,0,5,1,4,0,0,-1,-1,-1
"126","Dan Gosling",31,"1990","02","01","2017/2018","Midfielder","AFC Bournemouth",1942,841,1101,"England",28,13,15,2,2,0,1,1,0,0,0,4,2,2,36,15,21,8,0,154,206,-1
"127","Daniel Amartey",26,"1994","12","21","2017/2018","Midfielder","Leicester City",505,233,272,"Ghana",8,4,4,0,0,0,0,0,0,0,0,3,2,1,7,1,6,2,1,338,318,-1
"128","Daniel Bachmann",26,"1994","07","08","2017/2018","Goalkeeper","Watford",0,0,0,"Austria",0,0,0,0,0,0,0,0,0,0,0,0,0,0,0,0,0,0,0,-1,-1,-1
"129","Daniel Sturridge",31,"1989","08","31","2017/2018","Forward","West Bromwich Albion",547,396,151,"England",15,8,7,2,2,0,1,0,1,0,0,6,5,1,8,4,4,0,0,45,72,-1
"130","Daniel William John Ings",28,"1992","07","22","2017/2018","Forward","Liverpool",265,90,175,"England",8,4,4,1,0,1,0,0,0,0,0,5,3,2,0,0,0,0,0,-1,-1,-1
"131","Daniel Williams",32,"1989","03","08","2017/2018","Midfielder","Huddersfield Town",1117,447,670,"USA",20,9,11,0,0,0,0,0,0,0,0,6,5,1,21,7,14,2,0,406,350,-1
"132","Danilo",29,"1991","07","14","2017/2018","Defender","Manchester City",1341,552,789,"Brazil",23,11,12,3,2,1,2,1,1,0,0,12,5,7,11,6,5,2,0,93,105,20
"133","Danny Drinkwater",31,"1990","03","05","2017/2018","Midfielder","Chelsea",522,205,317,"England",12,5,7,1,1,0,0,0,0,0,0,6,4,2,5,1,4,0,0,107,280,-1
"134","Danny Rose",30,"1990","07","01","2017/2018","Defender","Tottenham Hotspur",802,362,440,"England",10,5,5,0,0,0,1,1,0,0,0,3,3,0,13,6,7,4,0,249,125,122
"135","Danny Simpson",34,"1987","01","04","2017/2018","Defender","Leicester City",2312,1132,1180,"England",28,14,14,0,0,0,0,0,0,0,0,5,3,2,39,16,23,4,0,334,247,142
"136","Danny Ward",27,"1993","06","21","2017/2018","Goalkeeper","Liverpool",0,0,0,"Wales",0,0,0,0,0,0,0,0,0,0,0,0,0,0,0,0,0,0,0,-1,-1,-1
"137","Danny Welbeck",30,"1990","11","26","2017/2018","Forward","Arsenal",1185,598,587,"England",28,13,15,5,5,0,2,2,0,0,0,10,6,4,19,10,9,1,0,34,79,-1
"138","Darren Fletcher",37,"1984","02","01","2017/2018","Midfielder","Stoke City",2223,1050,1173,"Scotland",27,13,14,1,0,1,1,0,1,0,0,5,3,2,48,18,30,0,0,225,217,-1
"139","Daryl Janmaat",31,"1989","07","21","2017/2018","Defender","Watford",1822,994,828,"Netherlands",23,12,11,3,1,2,0,0,0,0,0,3,2,1,33,19,14,3,0,121,283,158
"140","David de Gea",30,"1990","11","07","2017/2018","Goalkeeper","Manchester United",3330,1620,1710,"Spain",37,18,19,0,0,0,0,0,0,0,0,18,11,7,27,9,18,0,0,375,397,18
"141","David Luiz",33,"1987","04","21","2017/2018","Defender","Chelsea",839,357,482,"Brazil",10,4,6,1,1,0,0,0,0,0,0,4,2,2,12,5,7,5,1,140,249,79
"142","David Ospina Ramírez",32,"1988","08","30","2017/2018","Goalkeeper","Arsenal",380,200,180,"Colombia",5,3,2,0,0,0,0,0,0,0,0,2,1,1,2,1,1,0,0,331,274,5
"143","David Silva",35,"1986","01","08","2017/2018","Midfielder","Manchester City",2437,1297,1140,"Spain",29,16,13,9,3,6,11,4,7,0,0,15,8,7,17,11,6,5,0,46,7,-1
"144","Davide Zappacosta",28,"1992","06","10","2017/2018","Defender","Chelsea",1095,486,609,"Italy",22,10,12,1,1,0,1,0,1,0,0,10,6,4,12,3,9,0,0,178,159,51
"145","Davinson Sánchez Mina",24,"1996","06","11","2017/2018","Defender","Tottenham Hotspur",2534,1272,1262,"Colombia",31,16,15,0,0,0,0,0,0,0,0,14,9,5,20,8,12,2,1,271,253,15
"146","Davy Klaassen",28,"1993","02","21","2017/2018","Midfielder","Everton",250,177,73,"Netherlands",7,5,2,0,0,0,0,0,0,0,0,2,2,0,6,3,3,0,0,-1,-1,-1
"147","Davy Pröpper",29,"1991","09","01","2017/2018","Midfielder","Brighton & Hove Albion",3120,1604,1516,"Netherlands",35,18,17,0,0,0,4,2,2,0,0,9,5,4,48,22,26,3,1,370,107,-1
"148","Dean Marney",37,"1984","01","31","2017/2018","Midfielder","Burnley",0,0,0,"England",0,0,0,0,0,0,0,0,0,0,0,0,0,0,0,0,0,0,0,-1,-1,-1
"149","Dean Whitehead",39,"1982","01","21","2017/2018","Midfielder","Huddersfield Town",67,55,12,"England",4,3,1,0,0,0,0,0,0,0,0,0,0,0,2,1,1,0,0,-1,-1,-1
"150","DeAndre Yedlin",27,"1993","07","08","2017/2018","Defender","Newcastle United",2842,1530,1312,"USA",34,17,17,0,0,0,2,1,1,0,0,7,6,1,36,14,22,5,0,290,188,63
"151","Declan Rice",22,"1999","01","14","2017/2018","Midfielder","West Ham United",1422,560,862,"Republic of Ireland",26,10,16,0,0,0,0,0,0,0,0,6,4,2,26,7,19,1,0,258,376,-1
"152","Dejan Lovren",31,"1989","07","04","2017/2018","Defender","Liverpool",2124,983,1141,"Croatia",29,12,17,2,1,1,1,0,1,0,0,13,8,5,21,5,16,4,0,169,212,40
"153","Dele Alli",24,"1996","04","10","2017/2018","Midfielder","Tottenham Hotspur",2972,1415,1557,"England",36,18,18,9,4,5,10,6,4,0,0,15,9,6,26,10,16,7,0,63,19,-1
"154","Demarai Gray",24,"1996","06","27","2017/2018","Midfielder","Leicester City",1690,796,894,"England",35,17,18,3,2,1,1,0,1,0,0,9,6,3,32,11,21,2,0,113,209,-1
"155","Diafra Sakho",31,"1989","12","24","2017/2018","Forward","West Ham United",292,59,233,"Senegal",14,5,9,2,1,1,0,0,0,0,0,5,3,2,9,1,8,2,0,9,375,-1
"156","Didier Ndong Ibrahim",26,"1994","06","16","2017/2018","Midfielder","Watford",0,0,0,"Gabon",0,0,0,0,0,0,0,0,0,0,0,0,0,0,0,0,0,0,0,-1,-1,-1
"157","Diego Cavalieri",38,"1982","12","01","2017/2018","Goalkeeper","Crystal Palace",0,0,0,"Brazil",0,0,0,0,0,0,0,0,0,0,0,0,0,0,0,0,0,0,0,-1,-1,-1
"158","Dion Henry",23,"1997","09","11","2017/2018","Goalkeeper","Crystal Palace",0,0,0,"England",0,0,0,0,0,0,0,0,0,0,0,0,0,0,0,0,0,0,0,-1,-1,-1
"159","Divock Origi",25,"1995","04","17","2017/2018","Forward","Liverpool",9,0,9,"Belgium",1,0,1,0,0,0,0,0,0,0,0,0,0,0,0,0,0,0,0,-1,-1,-1
"160","Dodi Lukebakio",23,"1997","09","23","2017/2018","Midfielder","Watford",15,0,15,"Belgium",1,0,1,0,0,0,0,0,0,0,0,0,0,0,1,0,1,0,0,-1,-1,-1
"161","Domingos Quina",21,"1999","11","18","2017/2018","Midfielder","West Ham United",0,0,0,"Portugal",0,0,0,0,0,0,0,0,0,0,0,0,0,0,0,0,0,0,0,-1,-1,-1
"162","Dominic Calvert-Lewin",24,"1997","03","16","2017/2018","Forward","Everton",1874,941,933,"England",32,16,16,4,3,1,6,3,3,0,0,9,7,2,26,9,17,4,0,98,21,-1
"163","Dominic Solanke",23,"1997","09","13","2017/2018","Forward","Liverpool",582,254,328,"England",21,10,11,1,1,0,1,0,1,0,0,11,7,4,3,1,2,0,0,126,83,-1
"164","Dujon Sterling",21,"1999","10","23","2017/2018","Defender","Chelsea",0,0,0,"England",0,0,0,0,0,0,0,0,0,0,0,0,0,0,0,0,0,0,0,-1,-1,-1
"165","Dušan Tadić",32,"1988","11","20","2017/2018","Midfielder","Southampton",2812,1511,1301,"Serbia",36,19,17,6,5,1,3,2,1,1,0,8,3,5,40,21,19,4,0,99,133,-1
"166","Dwight Gayle",30,"1990","10","16","2017/2018","Forward","Newcastle United",1961,1046,915,"England",35,17,18,6,2,4,3,3,0,0,0,7,5,2,30,12,18,3,0,60,88,-1
"167","Dwight McNeil",21,"1999","11","22","2017/2018","Forward","Burnley",0,0,0,"England",1,1,0,0,0,0,0,0,0,0,0,0,0,0,0,0,0,0,0,-1,-1,-1
"168","Eden Hazard",30,"1991","01","07","2017/2018","Midfielder","Chelsea",2433,1125,1308,"Belgium",34,16,18,12,4,8,4,1,3,2,0,14,8,6,26,11,15,2,0,26,87,-1
"169","Ederson",27,"1993","08","16","2017/2018","Goalkeeper","Manchester City",3195,1575,1620,"Brazil",36,18,18,0,0,0,0,0,0,0,0,17,8,9,24,12,12,1,0,358,362,12
"170","Edimilson Fernandes",24,"1996","04","14","2017/2018","Midfielder","West Ham United",846,353,493,"Switzerland",14,6,8,0,0,0,1,1,0,0,0,2,1,1,18,8,10,1,0,299,124,-1
"171","Eduardo dos Reis Carvalho",38,"1982","09","18","2017/2018","Goalkeeper","Chelsea",0,0,0,"Portugal",0,0,0,0,0,0,0,0,0,0,0,0,0,0,0,0,0,0,0,-1,-1,-1
"172","Edward Nketiah",21,"1999","05","29","2017/2018","Forward","Arsenal",17,0,17,"England",3,0,3,0,0,0,0,0,0,0,0,0,0,0,0,0,0,0,0,-1,-1,-1
"173","Eldin Jakupovic",36,"1984","10","01","2017/2018","Goalkeeper","Leicester City",180,90,90,"Switzerland",2,1,1,0,0,0,0,0,0,0,0,0,0,0,6,1,5,0,0,-1,-1,-1
"174","Eliaquim Mangala",30,"1991","02","13","2017/2018","Defender","Everton",618,244,374,"France",11,4,7,0,0,0,0,0,0,0,0,5,1,4,6,1,5,0,0,361,326,36
"175","Elias Kachunga",28,"1992","04","21","2017/2018","Forward","Huddersfield Town",1338,622,716,"Congo DR",19,9,10,1,0,1,1,1,0,0,0,6,4,2,22,7,15,1,0,189,171,-1
"176","Emerson Hyndman",24,"1996","04","08","2017/2018","Midfielder","AFC Bournemouth",59,0,59,"USA",1,0,1,0,0,0,0,0,0,0,0,0,0,0,1,0,1,0,0,-1,-1,-1
"177","Emerson Palmieri dos Santos",26,"1994","08","02","2017/2018","Defender","Chelsea",279,7,272,"Italy",5,1,4,0,0,0,1,0,1,0,0,1,0,1,4,0,4,0,0,412,15,81
"178","Emre Can",27,"1994","01","12","2017/2018","Midfielder","Liverpool",2094,947,1147,"Germany",26,13,13,3,1,2,4,2,2,0,0,11,8,3,26,5,21,8,0,131,68,-1
"179","Erdal Rakip",25,"1996","02","13","2017/2018","Midfielder","Crystal Palace",0,0,0,"Sweden",0,0,0,0,0,0,0,0,0,0,0,0,0,0,0,0,0,0,0,-1,-1,-1
"180","Eric Bertrand Bailly",26,"1994","04","11","2017/2018","Defender","Manchester United",999,549,450,"Côte d'Ivoire",13,7,6,1,0,1,0,0,0,0,0,8,5,3,6,1,5,2,0,166,400,6
"181","Eric Dier",27,"1994","01","15","2017/2018","Midfielder","Tottenham Hotspur",2827,1485,1342,"England",34,18,16,0,0,0,2,1,1,0,0,15,9,6,27,13,14,4,0,372,178,-1
"182","Erik Lamela",29,"1992","03","04","2017/2018","Midfielder","Tottenham Hotspur",832,343,489,"Argentina",25,12,13,2,2,0,2,1,1,0,0,10,7,3,10,8,2,4,0,79,50,-1
"183","Erik Pieters",32,"1988","08","06","2017/2018","Defender","Stoke City",2720,1393,1327,"Netherlands",31,16,15,0,0,0,1,1,0,0,0,6,3,3,48,22,26,5,0,300,234,149
"184","Erwin Mulder",32,"1989","03","03","2017/2018","Goalkeeper","Swansea City",0,0,0,"Netherlands",0,0,0,0,0,0,0,0,0,0,0,0,0,0,0,0,0,0,0,-1,-1,-1
"185","Ethan Ampadu",20,"2000","09","13","2017/2018","Midfielder","Chelsea",10,0,10,"Wales",1,0,1,0,0,0,0,0,0,0,0,0,0,0,0,0,0,0,0,-1,-1,-1
"186","Etienne Capoue",32,"1988","07","10","2017/2018","Midfielder","Watford",1542,807,735,"France",23,12,11,1,0,1,0,0,0,0,0,5,3,2,27,11,16,3,0,195,315,-1
"187","Fabian Delph",31,"1989","11","21","2017/2018","Midfielder","Manchester City",1746,953,793,"England",22,12,10,1,1,0,2,2,0,0,0,9,5,4,15,9,6,2,0,210,131,-1
"188","Faustino Marcos Alberto Rojo",31,"1990","03","20","2017/2018","Defender","Manchester United",642,272,370,"Argentina",9,4,5,0,0,0,0,0,0,0,0,3,2,1,8,3,5,6,0,250,261,59
"189","Federico Fernández",32,"1989","02","21","2017/2018","Defender","Swansea City",2677,1260,1417,"Argentina",30,14,16,1,0,1,1,1,0,0,0,7,3,4,41,16,25,5,0,241,227,100
"190","Fernando Llorente Torres",36,"1985","02","26","2017/2018","Forward","Tottenham Hotspur",224,78,146,"Spain",16,7,9,1,0,1,0,0,0,0,0,5,3,2,1,0,1,1,0,-1,-1,-1
"191","Fernando Luiz Rosa",35,"1985","05","03","2017/2018","Midfielder","Manchester City",2885,1387,1498,"Brazil",34,17,17,5,3,2,3,2,1,0,0,15,6,9,22,11,11,7,0,115,138,-1
"192","Fikayo Tomori",23,"1997","12","19","2017/2018","Defender","Chelsea",0,0,0,"England",0,0,0,0,0,0,0,0,0,0,0,0,0,0,0,0,0,0,0,-1,-1,-1
"193","Florent Hadergjonaj",26,"1994","07","30","2017/2018","Defender","Huddersfield Town",1673,789,884,"Switzerland",23,10,13,0,0,0,1,1,0,0,0,6,4,2,28,9,19,3,0,296,191,139
"194","Florian Lejeune",29,"1991","05","19","2017/2018","Defender","Newcastle United",2104,1024,1080,"France",24,12,12,0,0,0,2,1,1,0,0,5,5,0,31,9,22,3,0,363,139,88
"195","Fousseni Diabaté",25,"1995","10","17","2017/2018","Midfielder","Leicester City",582,353,229,"Mali",14,7,7,0,0,0,1,1,0,0,0,2,1,1,11,5,6,1,0,285,82,-1
"196","Francis Coquelin",29,"1991","05","12","2017/2018","Midfielder","Arsenal",164,41,123,"France",7,3,4,0,0,0,0,0,0,0,0,3,3,0,5,0,5,0,0,-1,-1,-1
"197","Francisco Femenía Far",30,"1991","02","02","2017/2018","Midfielder","Watford",1715,833,882,"Spain",23,11,12,1,1,0,1,0,1,0,0,7,4,3,31,13,18,2,0,214,204,-1
"198","Fraser Forster",33,"1988","03","17","2017/2018","Goalkeeper","Southampton",1800,990,810,"England",20,11,9,0,0,0,0,0,0,0,0,4,2,2,29,15,14,0,0,317,408,121
"199","Freddie Ladapo",28,"1993","02","01","2017/2018","Forward","Crystal Palace",16,0,16,"England",1,0,1,0,0,0,0,0,0,0,0,0,0,0,1,0,1,0,0,-1,-1,-1
"200","Freddie Woodman",24,"1997","03","04","2017/2018","Goalkeeper","Newcastle United",0,0,0,"England",0,0,0,0,0,0,0,0,0,0,0,0,0,0,0,0,0,0,0,-1,-1,-1
"201","Fredrik Ulvestad",28,"1992","06","16","2017/2018","Midfielder","Burnley",0,0,0,"Norway",0,0,0,0,0,0,0,0,0,0,0,0,0,0,0,0,0,0,0,-1,-1,-1
"202","Gabriel Jesus",23,"1997","04","02","2017/2018","Forward","Manchester City",1672,644,1028,"Brazil",29,13,16,13,6,7,3,1,2,0,2,14,5,9,11,5,6,6,0,5,73,-1
"203","Gaëtan Bong Songo",32,"1988","04","24","2017/2018","Defender","Brighton & Hove Albion",2238,990,1248,"Cameroon",25,11,14,0,0,0,0,0,0,0,0,6,2,4,35,14,21,2,0,287,387,110
"204","Gareth Barry",40,"1981","02","23","2017/2018","Midfielder","West Bromwich Albion",1926,1020,906,"England",25,13,12,1,1,0,1,1,0,0,0,5,4,1,32,16,16,4,0,207,195,-1
"205","Gareth McAuley",41,"1979","12","05","2017/2018","Defender","West Bromwich Albion",456,254,202,"Northern Ireland",9,4,5,0,0,0,0,0,0,0,0,1,1,0,15,10,5,0,0,263,288,176
"206","Gary Cahill",35,"1985","12","19","2017/2018","Defender","Chelsea",2084,1153,931,"England",27,16,11,0,0,0,0,0,0,0,0,12,9,3,21,7,14,2,1,352,252,42
"207","Geoff Cameron",35,"1985","07","10","2017/2018","Defender","Stoke City",1525,693,832,"USA",20,9,11,0,0,0,0,0,0,0,0,3,2,1,30,11,19,2,0,312,373,168
"208","George Thomas",24,"1997","03","24","2017/2018","Midfielder","Leicester City",0,0,0,"Wales",0,0,0,0,0,0,0,0,0,0,0,0,0,0,0,0,0,0,0,-1,-1,-1
"209","Georges-Kevin N'Koudou Mbida",26,"1995","02","13","2017/2018","Forward","Burnley",224,27,197,"France",9,3,6,0,0,0,0,0,0,0,0,2,2,0,2,0,2,1,0,-1,-1,-1
"210","Georginio Wijnaldum",30,"1990","11","11","2017/2018","Midfielder","Liverpool",2387,1084,1303,"Netherlands",33,15,18,1,1,0,2,1,1,0,0,16,11,5,20,4,16,1,0,229,154,-1
"211","Gerard Deulofeu",27,"1994","03","13","2017/2018","Forward","Watford",438,186,252,"Spain",7,3,4,1,1,0,0,0,0,0,0,2,1,1,3,1,2,0,0,91,275,-1
"212","Glen Johnson",36,"1984","08","22","2017/2018","Defender","Stoke City",549,453,96,"England",9,7,2,0,0,0,0,0,0,0,0,0,0,0,14,11,3,3,0,315,389,174
"213","Glenn Murray",37,"1983","09","24","2017/2018","Forward","Brighton & Hove Albion",2197,1220,977,"England",35,18,17,12,7,5,0,0,0,4,2,8,4,4,35,19,16,9,0,20,361,-1
"214","Glyn Oliver Myhill",38,"1982","11","09","2017/2018","Goalkeeper","West Bromwich Albion",90,0,90,"Wales",1,0,1,0,0,0,0,0,0,0,0,0,0,0,1,0,1,1,0,-1,-1,-1
"215","Gnégnéri Yaya Touré",37,"1983","05","12","2017/2018","Midfielder","Manchester City",228,159,69,"Côte d'Ivoire",10,5,5,0,0,0,2,1,1,0,0,5,2,3,2,2,0,1,0,-1,-1,-1
"216","Grady Diangana",22,"1998","04","18","2017/2018","Midfielder","West Ham United",0,0,0,"England",0,0,0,0,0,0,0,0,0,0,0,0,0,0,0,0,0,0,0,-1,-1,-1
"217","Granit Xhaka",28,"1992","09","26","2017/2018","Midfielder","Arsenal",3266,1607,1659,"Switzerland",38,19,19,1,1,0,7,4,3,0,0,13,9,4,46,20,26,10,0,239,64,-1
"218","Grzegorz Krychowiak",31,"1990","01","29","2017/2018","Midfielder","West Bromwich Albion",1643,673,970,"Poland",27,13,14,0,0,0,2,1,1,0,0,7,4,3,28,13,15,2,0,279,118,-1
"219","Guido Marcelo Carrillo",29,"1991","05","24","2017/2018","Forward","Southampton",451,213,238,"Argentina",7,3,4,0,0,0,1,0,1,0,0,1,1,0,8,2,6,0,0,265,57,-1
"220","Gylfi Sigurdsson",31,"1989","09","07","2017/2018","Midfielder","Everton",2262,1157,1105,"Iceland",27,13,14,4,3,1,3,2,1,0,0,6,4,2,37,14,23,2,0,116,112,-1
"221","Hal Robson-Kanu",31,"1989","05","20","2017/2018","Forward","West Bromwich Albion",828,367,461,"Wales",21,10,11,2,1,1,0,0,0,0,0,7,4,3,10,3,7,3,1,83,325,-1
"222","Hamza Choudhury",23,"1997","09","30","2017/2018","Midfielder","Leicester City",332,206,126,"England",8,5,3,0,0,0,1,1,0,0,0,1,1,0,9,3,6,1,0,255,26,-1
"223","Harry Arter",31,"1989","12","28","2017/2018","Midfielder","AFC Bournemouth",962,428,534,"Republic of Ireland",13,6,7,1,1,0,0,0,0,0,0,3,1,2,12,5,7,4,0,157,343,-1
"224","Harry Kane",27,"1993","07","27","2017/2018","Forward","Tottenham Hotspur",3083,1690,1393,"England",37,19,18,30,15,15,2,2,0,2,1,16,10,6,30,15,15,5,0,3,185,-1
"225","Harry Maguire",28,"1993","03","05","2017/2018","Defender","Leicester City",3420,1710,1710,"England",38,19,19,2,2,0,4,1,3,0,0,9,6,3,57,21,36,7,0,223,117,133
"226","Harry Souttar",22,"1998","10","21","2017/2018","Defender","Stoke City",0,0,0,"Scotland",0,0,0,0,0,0,0,0,0,0,0,0,0,0,0,0,0,0,0,-1,-1,-1
"227","Harry Winks",25,"1996","02","02","2017/2018","Midfielder","Tottenham Hotspur",771,440,331,"England",16,8,8,0,0,0,1,1,0,0,0,6,3,3,7,2,5,0,0,373,108,-1
"228","Harvey Lewis Barnes",23,"1997","12","09","2017/2018","Midfielder","Leicester City",7,2,5,"England",3,2,1,0,0,0,0,0,0,0,0,1,1,0,0,0,0,0,0,-1,-1,-1
"229","Hector Bellerin",26,"1995","03","19","2017/2018","Defender","Arsenal",3051,1604,1447,"Spain",35,18,17,2,1,1,3,3,0,0,0,12,8,4,41,20,21,5,0,201,153,68
"230","Henri Saivet",30,"1990","10","25","2017/2018","Forward","Newcastle United",84,0,84,"Senegal",1,0,1,1,0,1,0,0,0,0,0,0,0,0,2,0,2,0,0,-1,-1,-1
"231","Henrikh Mkhitaryan",32,"1989","01","21","2017/2018","Midfielder","Arsenal",1725,871,854,"Armenia",26,13,13,3,2,1,9,7,2,0,0,14,10,4,15,4,11,2,0,111,5,-1
"232","Heung-Min Son",28,"1992","07","07","2017/2018","Forward","Tottenham Hotspur",2311,1325,986,"South Korea",37,19,18,12,9,3,6,5,1,0,0,16,10,6,16,7,9,0,0,23,48,-1
"233","Heurelho da Silva Gomes",40,"1981","02","15","2017/2018","Goalkeeper","Watford",2129,1080,1049,"Brazil",24,12,12,0,0,0,0,0,0,0,0,5,2,3,37,24,13,0,0,340,294,146
"234","Hugo Lloris",34,"1986","12","26","2017/2018","Goalkeeper","Tottenham Hotspur",3240,1620,1620,"France",36,18,18,0,0,0,0,0,0,0,0,15,9,6,31,15,16,1,0,368,341,33
"235","Ibrahim Afellay",34,"1986","04","01","2017/2018","Midfielder","Stoke City",162,37,125,"Netherlands",6,3,3,0,0,0,0,0,0,0,0,0,0,0,9,2,7,1,0,-1,-1,-1
"236","Idrissa Gana Gueye",31,"1989","09","25","2017/2018","Midfielder","Everton",2757,1212,1545,"Senegal",33,15,18,2,0,2,1,1,0,0,0,8,6,2,42,12,30,8,1,185,228,-1
"237","İlkay Gündoğan",30,"1990","10","23","2017/2018","Midfielder","Manchester City",1508,735,773,"Germany",30,13,17,4,2,2,1,1,0,1,0,15,6,9,13,6,7,3,0,72,182,-1
"238","Isaac Ajayi Success",25,"1996","01","07","2017/2018","Forward","Watford",0,0,0,"Nigeria",0,0,0,0,0,0,0,0,0,0,0,0,0,0,0,0,0,0,0,-1,-1,-1
"239","Isaac Hayden",26,"1995","03","22","2017/2018","Midfielder","Newcastle United",1370,612,758,"England",26,11,15,1,0,1,0,0,0,0,0,8,6,2,24,6,18,7,0,188,334,-1
"240","Isaiah Brown",24,"1997","01","07","2017/2018","Forward","Brighton & Hove Albion",306,136,170,"England",13,8,5,0,0,0,0,0,0,0,0,4,2,2,7,3,4,0,0,383,360,-1
"241","Islam Slimani",32,"1988","06","17","2017/2018","Forward","Newcastle United",370,252,118,"Algeria",16,10,6,1,1,0,1,1,0,0,0,3,3,0,4,1,3,1,0,69,37,-1
"242","Jack Butland",28,"1993","03","10","2017/2018","Goalkeeper","Stoke City",3150,1620,1530,"England",35,18,17,0,0,0,0,0,0,0,0,6,3,3,60,27,33,0,0,311,321,166
"243","Jack Cork",31,"1989","06","24","2017/2018","Midfielder","Burnley",3420,1710,1710,"England",38,19,19,2,1,1,1,0,1,0,0,12,7,5,34,13,21,7,0,215,232,-1
"244","Jack Simpson",24,"1996","12","18","2017/2018","Defender","AFC Bournemouth",72,0,72,"England",1,0,1,0,0,0,0,0,0,0,0,0,0,0,2,0,2,0,0,-1,-1,-1
"245","Jack Stephens",27,"1994","01","27","2017/2018","Defender","Southampton",1980,990,990,"England",22,11,11,2,1,1,0,0,0,0,0,5,2,3,31,12,19,7,1,162,405,109
"246","Jack Wilshere",29,"1992","01","01","2017/2018","Midfielder","Arsenal",1187,578,609,"England",20,10,10,1,1,0,3,1,2,0,0,7,5,2,15,7,8,6,0,173,49,-1
"247","Jacob Murphy",26,"1995","02","24","2017/2018","Midfielder","Newcastle United",1144,406,738,"England",25,10,15,1,0,1,1,0,1,0,0,5,3,2,24,7,17,0,0,168,161,-1
"248","Jaïro Riedewald",24,"1996","09","08","2017/2018","Defender","Crystal Palace",434,384,50,"Netherlands",12,7,5,0,0,0,0,0,0,0,0,3,2,1,5,4,1,0,0,395,358,57
"249","Jake Livermore",31,"1989","11","14","2017/2018","Midfielder","West Bromwich Albion",2675,1299,1376,"England",34,17,17,2,2,0,2,0,2,0,0,9,5,4,38,21,17,5,0,182,170,-1
"250","Jakob Haugaard",28,"1992","04","30","2017/2018","Goalkeeper","Stoke City",0,0,0,"Denmark",0,0,0,0,0,0,0,0,0,0,0,0,0,0,0,0,0,0,0,-1,-1,-1
"251","Jamal Lascelles",27,"1993","11","11","2017/2018","Defender","Newcastle United",2928,1488,1440,"England",33,17,16,3,2,1,0,0,0,0,0,9,7,2,31,10,21,5,0,159,337,47
"252","James Collins",37,"1983","08","22","2017/2018","Defender","West Ham United",1050,452,598,"Wales",13,6,7,1,0,1,0,0,0,0,0,4,2,2,18,5,13,3,0,158,369,145
"253","James Daly",21,"2000","01","12","2017/2018","Forward","Crystal Palace",0,0,0,"England",0,0,0,0,0,0,0,0,0,0,0,0,0,0,0,0,0,0,0,-1,-1,-1
"254","James McArthur",33,"1987","10","06","2017/2018","Midfielder","Crystal Palace",2434,1131,1303,"Scotland",33,16,17,5,3,2,1,1,0,0,0,8,3,5,34,16,18,5,0,103,222,-1
"255","James McCarthy",30,"1990","11","12","2017/2018","Midfielder","Everton",207,89,118,"Republic of Ireland",4,2,2,0,0,0,0,0,0,0,0,0,0,0,6,2,4,0,0,-1,-1,-1
"256","James McClean",31,"1989","04","21","2017/2018","Midfielder","West Bromwich Albion",1396,623,773,"Republic of Ireland",30,16,14,1,0,1,0,0,0,0,0,9,5,4,19,9,10,7,0,199,329,-1
"257","James Milner",35,"1986","01","04","2017/2018","Midfielder","Liverpool",1762,866,896,"England",32,16,16,0,0,0,3,2,1,0,0,13,9,4,22,6,16,3,0,348,85,-1
"258","James Morrison",34,"1986","05","24","2017/2018","Midfielder","West Bromwich Albion",206,160,46,"Scotland",4,2,2,1,0,1,0,0,0,0,0,1,1,0,1,0,1,0,0,-1,-1,-1
"259","James Tarkowski",28,"1992","11","19","2017/2018","Defender","Burnley",2790,1440,1350,"England",31,16,15,0,0,0,0,0,0,0,0,11,7,4,27,9,18,5,0,325,276,35
"260","James Tomkins",31,"1989","03","28","2017/2018","Defender","Crystal Palace",2388,1218,1170,"England",28,15,13,3,2,1,0,0,0,0,0,8,4,4,30,14,16,8,0,143,352,62
"261","James Ward-Prowse",26,"1994","11","01","2017/2018","Midfielder","Southampton",1716,855,861,"England",30,16,14,3,0,3,3,2,1,0,0,5,1,4,26,13,13,3,0,112,78,-1
"262","Jamie Murphy",31,"1989","08","27","2017/2018","Midfielder","Brighton & Hove Albion",165,75,90,"Scotland",4,2,2,0,0,0,0,0,0,0,0,2,1,1,4,2,2,0,0,-1,-1,-1
"263","Jamie Vardy",34,"1987","01","11","2017/2018","Forward","Leicester City",3258,1612,1646,"England",37,18,19,20,9,11,1,0,1,5,1,8,5,3,55,21,34,3,0,16,241,-1
"264","Jan Bednarek",24,"1996","04","11","2017/2018","Defender","Southampton",428,180,248,"Poland",5,2,3,1,1,0,0,0,0,0,0,2,0,2,4,4,0,1,0,85,394,28
"265","Jan Vertonghen",33,"1987","04","23","2017/2018","Defender","Tottenham Hotspur",3205,1590,1615,"Belgium",36,18,18,0,0,0,0,0,0,0,0,15,10,5,28,11,17,4,0,357,342,23
"266","Jarosław Jach",27,"1994","02","17","2017/2018","Defender","Crystal Palace",0,0,0,"Poland",0,0,0,0,0,0,0,0,0,0,0,0,0,0,0,0,0,0,0,-1,-1,-1
"267","Jason Eyenga-Lokilo",22,"1998","09","16","2017/2018","Forward","Crystal Palace",0,0,0,"Congo DR",0,0,0,0,0,0,0,0,0,0,0,0,0,0,0,0,0,0,0,-1,-1,-1
"268","Jason Puncheon",34,"1986","06","25","2017/2018","Midfielder","Crystal Palace",570,305,265,"England",10,6,4,0,0,0,0,0,0,0,0,1,1,0,13,6,7,5,0,397,355,-1
"269","Javier Hernandez",32,"1988","05","31","2017/2018","Forward","West Ham United",1543,691,852,"Mexico",28,14,14,8,3,5,0,0,0,0,0,6,4,2,32,13,19,3,0,24,374,-1
"270","Javier Manquillo Gaitán",26,"1994","05","04","2017/2018","Defender","Newcastle United",1759,810,949,"Spain",21,9,12,0,0,0,1,0,1,0,0,4,2,2,30,11,19,2,0,365,193,143
"271","Jay Fulton",26,"1994","04","03","2017/2018","Midfielder","Swansea City",17,1,16,"Scotland",2,1,1,0,0,0,0,0,0,0,0,1,0,1,0,0,0,1,0,-1,-1,-1
"272","Jay Rodriguez",31,"1989","07","28","2017/2018","Forward","West Bromwich Albion",2824,1354,1470,"England",37,18,19,7,4,3,1,1,0,1,0,10,6,4,38,18,20,2,0,84,237,-1
"273","Jayson Molumby",21,"1999","08","05","2017/2018","Midfielder","Brighton & Hove Albion",0,0,0,"Republic of Ireland",0,0,0,0,0,0,0,0,0,0,0,0,0,0,0,0,0,0,0,-1,-1,-1
"274","Jeff Hendrick",29,"1992","01","31","2017/2018","Midfielder","Burnley",2342,1164,1178,"Republic of Ireland",34,17,17,2,1,1,2,2,0,0,0,11,6,5,24,9,15,1,0,176,158,-1
"275","Jeffrey Schlupp",28,"1992","12","23","2017/2018","Defender","Crystal Palace",1748,792,956,"Ghana",24,10,14,0,0,0,1,1,0,0,0,5,1,4,30,15,15,3,0,386,207,144
"276","Jeremie Boga",24,"1997","01","03","2017/2018","Midfielder","Chelsea",18,18,0,"Côte d'Ivoire",1,1,0,0,0,0,0,0,0,0,0,0,0,0,0,0,0,0,0,-1,-1,-1
"277","Jérémy Pied",32,"1989","02","23","2017/2018","Defender","Southampton",180,90,90,"France",2,1,1,0,0,0,1,1,0,0,0,0,0,0,3,2,1,0,0,-1,-1,-1
"278","Jermain Defoe",38,"1982","10","06","2017/2018","Forward","AFC Bournemouth",1084,641,443,"England",24,13,11,4,1,3,1,0,1,0,0,2,1,1,20,13,7,1,0,47,167,-1
"279","Jerome Sinclair",24,"1996","09","19","2017/2018","Forward","Watford",27,0,27,"England",4,1,3,0,0,0,0,0,0,0,0,0,0,0,0,0,0,0,0,-1,-1,-1
"280","Jesé",28,"1993","02","26","2017/2018","Forward","Stoke City",617,405,212,"Spain",13,8,5,1,1,0,1,0,1,0,0,2,1,1,16,11,5,0,0,118,80,-1
"281","Jesse Lingard",28,"1992","12","15","2017/2018","Midfielder","Manchester United",1821,731,1090,"England",33,16,17,8,3,5,5,2,3,0,0,15,10,5,18,4,14,2,0,31,33,-1
"282","Jesús Gámez Duarte",35,"1985","04","09","2017/2018","Defender","Newcastle United",97,0,97,"Spain",2,0,2,0,0,0,0,0,0,0,0,1,0,1,0,0,0,0,0,-1,-1,-1
"283","Jiří Skalák",29,"1992","03","12","2017/2018","Midfielder","Brighton & Hove Albion",0,0,0,"Czech Republic",0,0,0,0,0,0,0,0,0,0,0,0,0,0,0,0,0,0,0,-1,-1,-1
"284","João Mário",28,"1993","01","19","2017/2018","Midfielder","West Ham United",1027,619,408,"Portugal",13,8,5,2,1,1,1,0,1,0,0,4,3,1,14,5,9,0,0,105,146,-1
"285","Joe Allen",31,"1990","03","14","2017/2018","Midfielder","Stoke City",3142,1710,1432,"Wales",36,19,17,2,2,0,6,3,3,0,0,6,3,3,53,30,23,8,0,206,67,-1
"286","Joe Gomez",23,"1997","05","22","2017/2018","Defender","Liverpool",1900,910,990,"England",23,11,12,0,0,0,2,2,0,0,0,10,7,3,20,5,15,3,0,349,151,48
"287","Joe Hart",33,"1987","04","18","2017/2018","Goalkeeper","West Ham United",1710,810,900,"England",19,9,10,0,0,0,1,0,1,0,0,4,3,1,36,15,21,0,0,380,194,170
"288","Joe Lolley",28,"1992","08","24","2017/2018","Forward","Huddersfield Town",219,131,88,"England",6,4,2,1,1,0,0,0,0,0,0,2,2,0,5,4,1,1,0,-1,-1,-1
"289","Joe Rodon",23,"1997","10","21","2017/2018","Defender","Swansea City",0,0,0,"Wales",0,0,0,0,0,0,0,0,0,0,0,0,0,0,0,0,0,0,0,-1,-1,-1
"290","Joel Coleman",25,"1995","09","25","2017/2018","Goalkeeper","Huddersfield Town",0,0,0,"England",0,0,0,0,0,0,0,0,0,0,0,0,0,0,0,0,0,0,0,-1,-1,-1
"291","Joel Matip",29,"1991","08","07","2017/2018","Defender","Liverpool",1994,1004,990,"Cameroon",25,13,12,1,0,1,0,0,0,0,0,10,7,3,23,7,16,3,0,217,305,55
"292","Joel Pereira Castro",24,"1996","06","27","2017/2018","Goalkeeper","Manchester United",0,0,0,"Portugal",0,0,0,0,0,0,0,0,0,0,0,0,0,0,0,0,0,0,0,-1,-1,-1
"293","Joel Robles Blázquez",30,"1990","06","16","2017/2018","Goalkeeper","Everton",0,0,0,"Spain",0,0,0,0,0,0,0,0,0,0,0,0,0,0,0,0,0,0,0,-1,-1,-1
"294","Joel Ward",31,"1989","10","28","2017/2018","Defender","Crystal Palace",1616,780,836,"England",19,9,10,0,0,0,1,1,0,0,0,4,1,3,25,14,11,4,0,394,177,107
"295","Johann Berg Guðmunds­son",30,"1990","10","26","2017/2018","Midfielder","Burnley",2839,1566,1273,"Iceland",35,19,16,2,2,0,8,6,2,0,0,11,7,4,29,12,17,2,0,204,31,-1
"296","John Stones",26,"1994","05","27","2017/2018","Defender","Manchester City",1305,734,571,"England",18,10,8,0,0,0,0,0,0,0,0,9,4,5,10,5,5,0,0,360,356,13
"297","Jon Flanagan",28,"1993","01","01","2017/2018","Defender","Liverpool",0,0,0,"England",0,0,0,0,0,0,0,0,0,0,0,0,0,0,0,0,0,0,0,-1,-1,-1
"298","Jon Gorenc Stankovič",25,"1996","01","14","2017/2018","Defender","Huddersfield Town",0,0,0,"Slovenia",0,0,0,0,0,0,0,0,0,0,0,0,0,0,0,0,0,0,0,-1,-1,-1
"299","Jonas Lössl",32,"1989","02","01","2017/2018","Goalkeeper","Huddersfield Town",3420,1710,1710,"Denmark",38,19,19,0,0,0,1,1,0,0,0,10,7,3,56,24,32,1,0,400,240,128
"300","Jonathan Hogg",32,"1988","12","06","2017/2018","Midfielder","Huddersfield Town",2408,1361,1047,"England",30,17,13,0,0,0,0,0,0,0,0,7,5,2,39,21,18,10,1,291,320,-1
"301","Jonathan Leko",21,"1999","04","23","2017/2018","Forward","West Bromwich Albion",0,0,0,"England",0,0,0,0,0,0,0,0,0,0,0,0,0,0,0,0,0,0,0,-1,-1,-1
"302","Jonathan Walters",37,"1983","09","19","2017/2018","Forward","Burnley",36,12,24,"Republic of Ireland",3,1,2,0,0,0,0,0,0,0,0,0,0,0,1,0,1,0,0,-1,-1,-1
"303","Jonjo Shelvey",29,"1992","02","27","2017/2018","Midfielder","Newcastle United",2268,1238,1030,"England",30,16,14,1,0,1,3,3,0,0,0,7,6,1,27,9,18,5,2,224,113,-1
"304","Jonjoe Kenny",24,"1997","03","15","2017/2018","Defender","Everton",1588,688,900,"England",19,9,10,0,0,0,1,1,0,0,0,5,3,2,29,8,21,2,0,269,186,160
"305","Jonny Evans",33,"1988","01","03","2017/2018","Defender","West Bromwich Albion",2272,1093,1179,"Northern Ireland",28,13,15,2,2,0,2,2,0,0,0,6,4,2,35,18,17,7,0,179,156,105
"306","Jordan Ayew",29,"1991","09","10","2017/2018","Forward","Swansea City",2859,1558,1301,"Ghana",36,19,17,7,4,3,2,2,0,1,0,9,5,4,46,22,24,3,1,80,190,-1
"307","Jordan Henderson",30,"1990","06","16","2017/2018","Midfielder","Liverpool",2173,1145,1028,"England",27,13,14,1,0,1,1,0,1,0,0,14,10,4,19,2,17,1,0,228,214,-1
"308","Jordan Hugill",28,"1992","06","03","2017/2018","Forward","West Ham United",22,12,10,"England",3,2,1,0,0,0,0,0,0,0,0,2,2,0,0,0,0,0,0,-1,-1,-1
"309","Jordan Pickford",27,"1994","03","07","2017/2018","Goalkeeper","Everton",3420,1710,1710,"England",38,19,19,0,0,0,0,0,0,0,0,10,7,3,55,20,35,0,0,304,268,120
"310","Jordi Osei-Tutu",22,"1998","10","01","2017/2018","Defender","Arsenal",0,0,0,"England",0,0,0,0,0,0,0,0,0,0,0,0,0,0,0,0,0,0,0,-1,-1,-1
"311","Jordon Ibe",25,"1995","12","08","2017/2018","Midfielder","AFC Bournemouth",1999,898,1101,"England",32,15,17,2,2,0,6,4,2,0,0,5,2,3,32,16,16,1,0,155,27,-1
"312","Jordon Mutch",29,"1991","12","02","2017/2018","Midfielder","Crystal Palace",0,0,0,"England",0,0,0,0,0,0,0,0,0,0,0,0,0,0,0,0,0,0,0,-1,-1,-1
"313","Jose Fonte",37,"1983","12","22","2017/2018","Defender","West Ham United",690,344,346,"Portugal",8,4,4,0,0,0,1,1,0,0,0,3,2,1,10,6,4,0,0,257,99,83
"314","José Holebas",36,"1984","06","26","2017/2018","Defender","Watford",2382,1076,1306,"Greece",28,13,15,0,0,0,4,2,2,0,0,7,4,3,43,19,24,7,0,342,81,156
"315","Jose Izquierdo",28,"1992","07","06","2017/2018","Forward","Brighton & Hove Albion",1987,988,999,"Colombia",32,16,16,5,2,3,3,3,0,0,0,8,4,4,30,14,16,2,0,73,97,-1
"316","José Leonardo Ulloa",34,"1986","07","25","2017/2018","Forward","Brighton & Hove Albion",279,62,217,"Argentina",14,5,9,1,0,1,0,0,0,0,0,2,1,1,3,0,3,0,0,48,386,-1
"317","José Luis Sanmartín Mato",30,"1990","03","26","2017/2018","Forward","Newcastle United",1716,913,803,"Spain",30,17,13,4,4,0,1,0,1,0,1,7,6,1,25,10,15,2,0,92,199,-1
"318","José Ramiro Funes Mori",30,"1991","03","05","2017/2018","Defender","Everton",119,44,75,"Argentina",4,1,3,0,0,0,0,0,0,0,0,1,0,1,2,1,1,1,0,-1,-1,-1
"319","Joseph Willock",21,"1999","08","19","2017/2018","Midfielder","Arsenal",82,0,82,"England",2,0,2,0,0,0,0,0,0,0,0,0,0,0,1,0,1,0,0,-1,-1,-1
"320","Josh Cullen",24,"1996","04","06","2017/2018","Midfielder","West Ham United",6,1,5,"Republic of Ireland",2,1,1,0,0,0,0,0,0,0,0,1,1,0,0,0,0,0,0,-1,-1,-1
"321","Josh Pask",23,"1997","11","01","2017/2018","Defender","West Ham United",0,0,0,"England",0,0,0,0,0,0,0,0,0,0,0,0,0,0,0,0,0,0,0,-1,-1,-1
"322","Josh Tymon",21,"1999","05","21","2017/2018","Defender","Stoke City",163,27,136,"England",3,1,2,0,0,0,0,0,0,0,0,0,0,0,9,2,7,0,0,-1,-1,-1
"323","Joshua King",29,"1992","01","15","2017/2018","Forward","AFC Bournemouth",2456,1241,1215,"Norway",33,17,16,8,3,5,3,3,0,2,0,6,3,3,34,17,17,3,0,56,123,-1
"324","Joshua Sims",23,"1997","03","28","2017/2018","Midfielder","Southampton",159,83,76,"England",6,2,4,0,0,0,0,0,0,0,0,1,1,0,2,0,2,0,0,-1,-1,-1
"325","Joy Mukena",21,"1999","07","02","2017/2018","Defender","Watford",0,0,0,"England",0,0,0,0,0,0,0,0,0,0,0,0,0,0,0,0,0,0,0,-1,-1,-1
"326","Juan Marcos Foyth",23,"1998","01","12","2017/2018","Defender","Tottenham Hotspur",0,0,0,"Argentina",0,0,0,0,0,0,0,0,0,0,0,0,0,0,0,0,0,0,0,-1,-1,-1
"327","Juan Mata",32,"1988","04","27","2017/2018","Midfielder","Manchester United",1933,1233,700,"Spain",28,16,12,3,1,2,5,4,1,0,0,15,11,4,10,5,5,1,0,127,46,-1
"328","Julián Speroni",41,"1979","05","17","2017/2018","Goalkeeper","Crystal Palace",990,540,450,"Argentina",11,6,5,0,0,0,0,0,0,0,0,2,0,2,14,11,3,0,0,398,349,75
"329","Julien Ngoy",23,"1997","11","02","2017/2018","Forward","Stoke City",19,0,19,"Belgium",1,0,1,0,0,0,0,0,0,0,0,0,0,0,2,0,2,0,0,-1,-1,-1
"330","Junior Stanislas",31,"1989","11","26","2017/2018","Midfielder","AFC Bournemouth",1296,594,702,"England",19,8,11,5,2,3,2,0,2,1,0,2,1,1,21,10,11,1,0,41,95,-1
"331","Jürgen Locadia",27,"1993","11","07","2017/2018","Forward","Brighton & Hove Albion",224,83,141,"Netherlands",6,2,4,1,1,0,1,0,1,0,0,0,0,0,8,1,7,0,0,-1,-1,-1
"332","Kane Wilson",21,"2000","03","11","2017/2018","Defender","West Bromwich Albion",0,0,0,"England",0,0,0,0,0,0,0,0,0,0,0,0,0,0,0,0,0,0,0,-1,-1,-1
"333","Karl Darlow",30,"1990","10","07","2017/2018","Goalkeeper","Newcastle United",900,450,450,"England",10,5,5,0,0,0,0,0,0,0,0,2,1,1,15,6,9,0,0,367,340,136
"334","Kasey Palmer",24,"1996","11","09","2017/2018","Midfielder","Huddersfield Town",168,52,116,"England",4,2,2,0,0,0,0,0,0,0,0,3,2,1,2,0,2,2,0,-1,-1,-1
"335","Kasper Schmeichel",34,"1986","11","05","2017/2018","Goalkeeper","Leicester City",2966,1440,1526,"Denmark",33,16,17,0,0,0,0,0,0,0,0,8,5,3,45,18,27,3,0,332,246,96
"336","Kazaiah Sterling",22,"1998","11","09","2017/2018","Forward","Tottenham Hotspur",0,0,0,"England",0,0,0,0,0,0,0,0,0,0,0,0,0,0,0,0,0,0,0,-1,-1,-1
"337","Kelechi Iheanacho",24,"1996","10","02","2017/2018","Forward","Leicester City",867,445,422,"Nigeria",21,11,10,3,1,2,3,1,2,0,0,3,2,1,18,4,14,2,0,52,17,-1
"338","Keshi Anderson",25,"1995","04","05","2017/2018","Forward","Crystal Palace",0,0,0,"England",0,0,0,0,0,0,0,0,0,0,0,0,0,0,0,0,0,0,0,-1,-1,-1
"339","Kevin De Bruyne",29,"1991","06","27","2017/2018","Midfielder","Manchester City",3085,1427,1658,"Belgium",37,18,19,8,5,3,16,12,4,0,0,18,8,10,20,8,12,2,0,75,4,-1
"340","Kevin Long",30,"1990","08","17","2017/2018","Defender","Burnley",1440,810,630,"Republic of Ireland",16,9,7,1,1,0,2,0,2,0,0,4,3,1,18,8,10,1,0,192,101,60
"341","Kevin Mirallas",33,"1987","10","04","2017/2018","Forward","Everton",138,13,125,"Belgium",5,1,4,0,0,0,0,0,0,0,0,1,1,0,7,0,7,1,0,-1,-1,-1
"342","Kevin Wimmer",28,"1992","11","15","2017/2018","Defender","Stoke City",1321,577,744,"Austria",17,7,10,0,0,0,0,0,0,0,0,1,0,1,31,10,21,5,0,374,396,173
"343","Kieran Gibbs",31,"1989","09","25","2017/2018","Defender","West Bromwich Albion",2831,1367,1464,"England",33,16,17,0,0,0,1,1,0,0,0,8,5,3,41,21,20,3,0,297,233,84
"344","Kieran Trippier",30,"1990","09","18","2017/2018","Defender","Tottenham Hotspur",1914,1073,841,"England",24,12,12,0,0,0,5,2,3,0,0,9,6,3,17,8,9,1,0,275,42,25
"345","Konstantinos Mavropanos",23,"1997","12","11","2017/2018","Defender","Arsenal",195,90,105,"Greece",3,1,2,0,0,0,0,0,0,0,0,1,1,0,2,0,2,1,1,-1,-1,-1
"346","Konstantinos Stafylidis",27,"1993","12","02","2017/2018","Defender","Stoke City",335,180,155,"Greece",5,2,3,0,0,0,0,0,0,0,0,1,0,1,6,4,2,0,0,274,278,155
"347","Kristoffer Nordfeldt",31,"1989","06","22","2017/2018","Goalkeeper","Swansea City",0,0,0,"Sweden",0,0,0,0,0,0,0,0,0,0,0,0,0,0,0,0,0,0,0,-1,-1,-1
"348","Kurt Zouma",26,"1994","10","27","2017/2018","Defender","Stoke City",2887,1381,1506,"France",34,17,17,1,0,1,0,0,0,0,0,6,3,3,48,21,27,1,0,240,372,135
"349","Kyle Bartley",29,"1991","05","21","2017/2018","Defender","Swansea City",233,67,166,"England",5,1,4,0,0,0,0,0,0,0,0,1,0,1,4,1,3,2,0,-1,-1,-1
"350","Kyle Jameson",22,"1998","09","10","2017/2018","Defender","West Bromwich Albion",0,0,0,"England",0,0,0,0,0,0,0,0,0,0,0,0,0,0,0,0,0,0,0,-1,-1,-1
"351","Kyle Naughton",32,"1988","11","11","2017/2018","Defender","Swansea City",3033,1505,1528,"England",34,17,17,0,0,0,2,1,1,0,0,9,5,4,47,19,28,1,0,322,181,104
"352","Kyle Scott",23,"1997","12","22","2017/2018","Midfielder","Chelsea",0,0,0,"USA",0,0,0,0,0,0,0,0,0,0,0,0,0,0,0,0,0,0,0,-1,-1,-1
"353","Kyle Taylor",21,"1999","08","27","2017/2018","Midfielder","AFC Bournemouth",0,0,0,"England",0,0,0,0,0,0,0,0,0,0,0,0,0,0,0,0,0,0,0,-1,-1,-1
"354","Kyle Walker",30,"1990","05","27","2017/2018","Defender","Manchester City",2787,1394,1393,"England",32,16,16,0,0,0,6,2,4,0,0,15,7,8,20,9,11,4,1,359,65,10
"355","Kyle Walker-Peters",23,"1997","04","12","2017/2018","Defender","Tottenham Hotspur",188,90,98,"England",3,1,2,0,0,0,2,2,0,0,0,2,0,2,4,4,0,0,0,-1,-1,-1
"356","Lasse Sørensen",21,"1999","10","20","2017/2018","Midfielder","Stoke City",76,0,76,"Denmark",1,0,1,0,0,0,1,0,1,0,0,0,0,0,1,0,1,0,0,-1,-1,-1
"357","Laurent Depoitre",32,"1988","12","07","2017/2018","Forward","Huddersfield Town",1808,824,984,"Belgium",33,15,18,6,3,3,1,0,1,0,0,7,5,2,32,14,18,1,0,53,192,-1
"358","Laurent Koscielny",35,"1985","09","09","2017/2018","Defender","Arsenal",2227,1080,1147,"France",25,12,13,2,2,0,0,0,0,0,0,8,5,3,31,13,18,4,0,170,250,74
"359","Layton Ndukwu",22,"1998","09","06","2017/2018","Forward","Leicester City",0,0,0,"England",0,0,0,0,0,0,0,0,0,0,0,0,0,0,0,0,0,0,0,-1,-1,-1
"360","Lee Grant",38,"1983","01","27","2017/2018","Goalkeeper","Stoke City",270,90,180,"England",3,1,2,0,0,0,0,0,0,0,0,0,0,0,6,3,3,0,0,-1,-1,-1
"361","Leighton Baines",36,"1984","12","11","2017/2018","Defender","Everton",1910,990,920,"England",22,11,11,2,1,1,3,2,1,2,0,5,4,1,31,14,17,1,0,165,98,123
"362","Leon Britton",38,"1982","09","15","2017/2018","Midfielder","Swansea City",305,162,143,"England",5,3,2,0,0,0,0,0,0,0,0,2,1,1,1,1,0,1,0,324,345,-1
"363","Leroy Fer",31,"1990","01","05","2017/2018","Midfielder","Swansea City",1397,648,749,"Netherlands",20,9,11,1,0,1,1,0,1,0,0,6,3,3,24,9,15,5,0,196,179,-1
"364","Leroy Sané",25,"1996","01","11","2017/2018","Midfielder","Manchester City",2423,1238,1185,"Germany",32,15,17,10,5,5,15,12,3,0,0,15,6,9,21,11,10,4,0,35,1,-1
"365","Levi Lumeka",22,"1998","09","04","2017/2018","Forward","Crystal Palace",25,0,25,"England",1,0,1,0,0,0,0,0,0,0,0,0,0,0,0,0,0,0,0,-1,-1,-1
"366","Lewis Cook",24,"1997","02","03","2017/2018","Midfielder","AFC Bournemouth",2238,1272,966,"England",29,16,13,0,0,0,2,1,1,0,0,5,3,2,39,23,16,5,0,266,157,-1
"367","Lewis Dunk",29,"1991","11","21","2017/2018","Defender","Brighton & Hove Albion",3420,1710,1710,"England",38,19,19,1,1,0,1,0,1,0,0,10,5,5,52,23,29,7,0,234,243,97
"368","Liam Rosenior",36,"1984","07","08","2017/2018","Defender","Brighton & Hove Albion",162,28,134,"England",3,1,2,0,0,0,0,0,0,0,0,1,0,1,3,1,2,0,0,-1,-1,-1
"369","Loris Karius",27,"1993","06","21","2017/2018","Goalkeeper","Liverpool",1710,990,720,"Germany",19,11,8,0,0,0,0,0,0,0,0,10,7,3,12,5,7,1,0,350,258,9
"370","Lucas Rodrigues Moura da Silva",28,"1992","08","12","2017/2018","Midfielder","Tottenham Hotspur",208,98,110,"Brazil",6,3,3,0,0,0,1,1,0,0,0,2,1,1,5,4,1,0,0,-1,-1,-1
"371","Luciano Narsingh",30,"1990","09","12","2017/2018","Forward","Swansea City",616,404,212,"Netherlands",18,11,7,1,0,1,0,0,0,0,0,2,2,0,14,9,5,0,0,125,339,-1
"372","Luka Milivojević",29,"1991","04","06","2017/2018","Midfielder","Crystal Palace",3082,1565,1517,"Serbia",36,19,17,10,4,6,1,1,0,7,1,8,4,4,51,24,27,8,0,58,239,-1
"373","Lukas Nmecha",22,"1998","12","14","2017/2018","Forward","Manchester City",14,4,10,"England",2,1,1,0,0,0,0,0,0,0,0,0,0,0,0,0,0,0,0,-1,-1,-1
"374","Luke Garbutt",27,"1993","05","20","2017/2018","Defender","Everton",0,0,0,"England",0,0,0,0,0,0,0,0,0,0,0,0,0,0,0,0,0,0,0,-1,-1,-1
"375","Luke Shaw",25,"1995","07","11","2017/2018","Defender","Manchester United",788,473,315,"England",11,6,5,0,0,0,0,0,0,0,0,8,5,3,2,2,0,2,0,252,287,2
"376","Lys Mousset",25,"1996","02","08","2017/2018","Forward","AFC Bournemouth",581,264,317,"France",23,11,12,2,2,0,0,0,0,0,0,2,1,1,12,5,7,1,0,51,365,-1
"377","Maarten Stekelenburg",38,"1982","09","21","2017/2018","Goalkeeper","Everton",0,0,0,"Netherlands",0,0,0,0,0,0,0,0,0,0,0,0,0,0,0,0,0,0,0,-1,-1,-1
"378","Mamadou Sakho",31,"1990","02","13","2017/2018","Defender","Crystal Palace",1600,700,900,"France",19,9,10,1,1,0,2,2,0,0,0,6,2,4,23,9,14,1,0,197,122,80
"379","Mame Biram Diouf",33,"1987","12","16","2017/2018","Forward","Stoke City",2602,1341,1261,"Senegal",35,17,18,6,5,1,2,2,0,0,0,6,3,3,49,23,26,6,0,88,173,-1
"380","Manolo Gabbiadini",29,"1991","11","26","2017/2018","Forward","Southampton",1072,673,399,"Italy",28,15,13,5,3,2,0,0,0,1,0,7,3,4,17,10,7,2,0,28,401,-1
"381","Manuel Lanzini",28,"1993","02","15","2017/2018","Midfielder","West Ham United",2047,973,1074,"Argentina",27,13,14,5,3,2,6,2,4,0,1,6,4,2,42,17,25,4,0,78,29,-1
"382","Marc Albrighton",31,"1989","11","18","2017/2018","Midfielder","Leicester City",2544,1357,1187,"England",34,17,17,2,1,1,7,3,4,0,0,9,6,3,38,17,21,6,1,190,34,-1
"383","Marc Pugh",33,"1987","04","01","2017/2018","Midfielder","AFC Bournemouth",983,564,419,"England",20,12,8,0,0,0,0,0,0,0,0,6,3,3,17,9,8,2,0,391,333,-1
"384","Marcos Alonso",30,"1990","12","28","2017/2018","Defender","Chelsea",2860,1591,1269,"Spain",33,18,15,7,3,4,2,0,2,0,0,14,9,5,27,15,12,6,0,82,184,30
"385","Marcus Browne",23,"1997","12","18","2017/2018","Midfielder","West Ham United",0,0,0,"England",0,0,0,0,0,0,0,0,0,0,0,0,0,0,0,0,0,0,0,-1,-1,-1
"386","Marcus Rashford",23,"1997","10","31","2017/2018","Forward","Manchester United",1805,1015,790,"England",35,18,17,7,5,2,5,4,1,0,0,19,12,7,15,7,8,3,0,42,32,-1
"387","Mario Lemina",27,"1993","08","31","2017/2018","Midfielder","Southampton",1723,844,879,"Gabon",25,11,14,1,0,1,1,1,0,0,0,5,2,3,29,13,16,2,0,219,208,-1
"388","Mark Noble",33,"1987","05","07","2017/2018","Midfielder","West Ham United",2404,1247,1157,"England",29,15,14,4,1,3,0,0,0,2,0,8,6,2,43,17,26,6,0,119,370,-1
"389","Marko Arnautović",31,"1989","04","18","2017/2018","Forward","West Ham United",2323,1281,1042,"Austria",31,16,15,11,6,5,6,2,4,0,0,8,5,3,46,21,25,6,1,27,43,-1
"390","Marko Grujić",24,"1996","04","12","2017/2018","Midfielder","Liverpool",13,6,7,"Serbia",3,1,2,0,0,0,0,0,0,0,0,1,1,0,0,0,0,0,0,-1,-1,-1
"391","Markus Suttner",33,"1987","04","15","2017/2018","Defender","Brighton & Hove Albion",1178,720,458,"Austria",14,8,6,0,0,0,0,0,0,0,0,4,3,1,17,9,8,0,0,411,346,85
"392","Marouane Fellaini",33,"1987","11","22","2017/2018","Midfielder","Manchester United",612,296,316,"Belgium",16,9,7,4,4,0,0,0,0,0,0,10,6,4,1,0,1,1,0,11,406,-1
"393","Martin Cranie",34,"1986","09","25","2017/2018","Defender","Huddersfield Town",180,29,151,"England",3,1,2,0,0,0,0,0,0,0,0,1,1,0,7,0,7,0,0,-1,-1,-1
"394","Martin Dúbravka",32,"1989","01","15","2017/2018","Goalkeeper","Newcastle United",1080,540,540,"Slovakia",12,6,6,0,0,0,0,0,0,0,0,4,4,0,11,2,9,0,0,253,265,46
"395","Martin Kelly",30,"1990","04","26","2017/2018","Defender","Crystal Palace",1194,514,680,"England",15,7,8,0,0,0,0,0,0,0,0,4,2,2,20,10,10,1,0,262,383,137
"396","Martin Olsson",32,"1988","05","16","2017/2018","Defender","Swansea City",3154,1552,1602,"Sweden",36,18,18,0,0,0,1,0,1,0,0,9,5,4,48,21,27,7,0,321,231,98
"397","Marvin Zeegelaar",30,"1990","08","11","2017/2018","Defender","Watford",995,630,365,"Netherlands",12,7,5,0,0,0,1,0,1,0,0,2,1,1,15,10,5,5,1,282,142,92
"398","Mason Holgate",24,"1996","10","21","2017/2018","Defender","Everton",1182,552,630,"England",15,7,8,0,0,0,0,0,0,0,0,5,3,2,14,5,9,3,0,310,382,58
"399","Massadio Haïdara",28,"1992","12","02","2017/2018","Defender","Newcastle United",3,3,0,"France",1,1,0,0,0,0,0,0,0,0,0,1,1,0,0,0,0,0,0,-1,-1,-1
"400","Mathew Ryan",28,"1992","04","07","2017/2018","Goalkeeper","Brighton & Hove Albion",3420,1710,1710,"Australia",38,19,19,0,0,0,0,0,0,0,0,10,5,5,52,23,29,0,0,409,353,95
"401","Mathias Jattah-Njie Jørgensen",30,"1990","04","22","2017/2018","Defender","Huddersfield Town",3420,1710,1710,"Denmark",38,19,19,0,0,0,2,2,0,0,0,10,7,3,56,24,32,6,0,401,202,126
"402","Mathieu Debuchy",35,"1985","07","27","2017/2018","Defender","Arsenal",0,0,0,"France",0,0,0,0,0,0,0,0,0,0,0,0,0,0,0,0,0,0,0,-1,-1,-1
"403","Matias Ezequiel Schelotto",31,"1989","05","22","2017/2018","Defender","Brighton & Hove Albion",1316,615,701,"Italy",20,9,11,0,0,0,0,0,0,0,0,2,0,2,29,12,17,3,0,293,316,172
"404","Matt Butcher",23,"1997","05","13","2017/2018","Midfielder","AFC Bournemouth",0,0,0,"England",0,0,0,0,0,0,0,0,0,0,0,0,0,0,0,0,0,0,0,-1,-1,-1
"405","Matt Macey",26,"1994","09","08","2017/2018","Goalkeeper","Arsenal",0,0,0,"England",0,0,0,0,0,0,0,0,0,0,0,0,0,0,0,0,0,0,0,-1,-1,-1
"406","Matt Phillips",30,"1991","03","13","2017/2018","Midfielder","West Bromwich Albion",2096,1281,815,"Scotland",30,17,13,2,1,1,2,1,1,0,0,8,5,3,31,18,13,3,0,163,137,-1
"407","Matt Ritchie",31,"1989","09","09","2017/2018","Midfielder","Newcastle United",2812,1441,1371,"Scotland",35,18,17,3,3,0,5,3,2,0,0,9,7,2,34,14,20,6,0,149,74,-1
"408","Matt Targett",25,"1995","09","17","2017/2018","Defender","Southampton",167,90,77,"England",2,1,1,0,0,0,0,0,0,0,0,0,0,0,6,1,5,0,0,-1,-1,-1
"409","Matteo Darmian",31,"1989","12","02","2017/2018","Defender","Manchester United",442,90,352,"Italy",8,3,5,0,0,0,0,0,0,0,0,4,2,2,3,0,3,0,0,379,411,8
"410","Matthew Lowton",31,"1989","06","08","2017/2018","Defender","Burnley",2294,1214,1080,"England",26,14,12,0,0,0,3,2,1,0,0,8,5,3,23,7,16,1,0,326,110,41
"411","Matty James",29,"1991","07","21","2017/2018","Midfielder","Leicester City",995,546,449,"England",13,7,6,0,0,0,0,0,0,0,0,4,3,1,14,4,10,2,0,336,307,-1
"412","Max Melbourne",22,"1998","10","23","2017/2018","Defender","West Bromwich Albion",0,0,0,"England",0,0,0,0,0,0,0,0,0,0,0,0,0,0,0,0,0,0,0,-1,-1,-1
"413","Maya Yoshida",32,"1988","08","23","2017/2018","Defender","Southampton",2051,1174,877,"Japan",24,14,10,2,1,1,0,0,0,0,0,6,2,4,29,18,11,4,1,161,407,76
"414","Mesut Özil",32,"1988","10","14","2017/2018","Midfielder","Arsenal",2164,1243,921,"Germany",26,15,11,4,3,1,8,6,2,0,0,8,7,1,35,16,19,4,0,108,14,-1
"415","Michael Carrick",39,"1981","07","27","2017/2018","Midfielder","Manchester United",109,85,24,"England",2,1,1,0,0,0,0,0,0,0,0,1,1,0,0,0,0,0,0,-1,-1,-1
"416","Michael Folivi",23,"1998","02","25","2017/2018","Forward","Watford",0,0,0,"England",0,0,0,0,0,0,0,0,0,0,0,0,0,0,0,0,0,0,0,-1,-1,-1
"417","Michael Hefele",30,"1990","08","31","2017/2018","Defender","Huddersfield Town",31,0,31,"Germany",2,1,1,0,0,0,0,0,0,0,0,1,1,0,1,0,1,1,0,-1,-1,-1
"418","Michael Keane",28,"1993","01","11","2017/2018","Defender","Everton",2561,1270,1291,"England",30,15,15,0,0,0,1,1,0,0,0,8,6,2,43,17,26,3,0,306,210,138
"419","Michael Obafemi",20,"2000","07","05","2017/2018","Forward","Southampton",8,8,0,"Republic of Ireland",1,1,0,0,0,0,0,0,0,0,0,0,0,0,0,0,0,0,0,-1,-1,-1
"420","Michail Antonio",30,"1990","03","27","2017/2018","Midfielder","West Ham United",1357,707,650,"England",21,10,11,3,0,3,1,1,0,0,0,8,6,2,22,8,14,1,0,95,172,-1
"421","Michel Vorm",37,"1983","10","19","2017/2018","Goalkeeper","Tottenham Hotspur",90,0,90,"Netherlands",1,0,1,0,0,0,0,0,0,0,0,0,0,0,1,0,1,0,0,-1,-1,-1
"422","Michy Batshuayi",27,"1993","10","01","2017/2018","Forward","Chelsea",353,144,209,"Belgium",12,6,6,2,2,0,1,0,1,0,0,6,3,3,6,3,3,0,0,17,36,-1
"423","Miguel Ángel Britos Cabrera",35,"1985","07","16","2017/2018","Defender","Watford",797,384,413,"Uruguay",12,6,6,1,1,0,0,0,0,0,0,5,3,2,14,5,9,4,1,141,291,148
"424","Mike van der Hoorn",28,"1992","10","14","2017/2018","Defender","Swansea City",1952,946,1006,"Netherlands",24,11,13,1,1,0,0,0,0,0,0,7,4,3,27,12,15,4,0,209,378,71
"425","Mikel Merino",24,"1996","06","21","2017/2018","Midfielder","Newcastle United",1343,693,650,"Spain",24,13,11,1,1,0,1,1,0,0,0,5,4,1,18,7,11,4,0,183,174,-1
"426","Mohamed Diamé",33,"1987","06","13","2017/2018","Midfielder","Newcastle United",2042,968,1074,"Senegal",31,15,16,2,0,2,0,0,0,0,0,8,6,2,27,9,18,3,0,160,266,-1
"427","Mohamed Elneny",28,"1992","07","10","2017/2018","Midfielder","Arsenal",870,555,315,"Egypt",13,8,5,0,0,0,1,1,0,0,0,5,4,1,11,6,5,4,1,330,135,-1
"428","Mohamed Salah",28,"1992","06","14","2017/2018","Forward","Liverpool",2922,1556,1366,"Egypt",36,19,17,32,19,13,10,8,2,1,1,16,12,4,29,7,22,1,0,1,16,-1
"429","Molla Wagué",30,"1991","02","21","2017/2018","Defender","Watford",439,244,195,"Mali",6,3,3,1,1,0,0,0,0,0,0,0,0,0,8,3,5,0,0,86,285,161
"430","Morgan Schneiderlin",31,"1989","11","08","2017/2018","Midfielder","Everton",2128,1029,1099,"France",30,15,15,0,0,0,0,0,0,0,0,8,5,3,37,14,23,7,1,307,368,-1
"431","Moritz Bauer",29,"1992","01","25","2017/2018","Defender","Stoke City",1309,609,700,"Switzerland",15,7,8,0,0,0,0,0,0,0,0,4,2,2,18,8,10,4,0,284,248,72
"432","Moses Makasi",25,"1995","09","21","2017/2018","Midfielder","West Ham United",0,0,0,"England",0,0,0,0,0,0,0,0,0,0,0,0,0,0,0,0,0,0,0,-1,-1,-1
"433","Moussa Dembele",33,"1987","07","15","2017/2018","Midfielder","Tottenham Hotspur",1885,895,990,"Belgium",28,13,15,0,0,0,0,0,0,0,0,11,7,4,20,6,14,6,0,371,367,-1
"434","Moussa Sissoko",31,"1989","08","15","2017/2018","Midfielder","Tottenham Hotspur",1393,650,743,"France",33,17,16,1,0,1,1,0,1,0,0,14,9,5,16,9,7,3,0,193,189,-1
"435","Muhamed Bešić",28,"1992","09","09","2017/2018","Midfielder","Everton",44,0,44,"Bosnia and Herzegovina",2,0,2,0,0,0,0,0,0,0,0,0,0,0,0,0,0,0,0,-1,-1,-1
"436","N'Golo Kanté",29,"1991","03","29","2017/2018","Midfielder","Chelsea",2998,1590,1408,"France",34,18,16,1,0,1,1,1,0,0,0,15,10,5,29,13,16,3,0,237,226,-1
"437","Nacer Chadli",31,"1989","08","01","2017/2018","Midfielder","West Bromwich Albion",215,11,204,"Belgium",5,1,4,1,0,1,0,0,0,0,0,1,1,0,3,0,3,1,0,-1,-1,-1
"438","Nacho Monreal",35,"1986","02","26","2017/2018","Defender","Arsenal",2244,1116,1128,"Spain",28,14,14,5,3,2,2,2,0,0,0,11,7,4,26,9,17,3,0,96,168,56
"439","Nahki Wells",30,"1990","05","31","2017/2018","Forward","Burnley",46,22,24,"Bermuda",9,5,4,0,0,0,0,0,0,0,0,1,0,1,0,0,0,0,0,-1,-1,-1
"440","Nathan Aké",26,"1995","02","18","2017/2018","Defender","AFC Bournemouth",3353,1710,1643,"Netherlands",38,19,19,2,1,1,3,2,1,0,0,6,3,3,54,28,26,5,0,212,160,119
"441","Nathan Dyer",33,"1987","11","29","2017/2018","Midfielder","Swansea City",1312,805,507,"England",24,14,10,0,0,0,0,0,0,0,0,4,4,0,20,9,11,2,0,246,297,-1
"442","Nathan Ferguson",20,"2000","10","05","2017/2018","Midfielder","West Bromwich Albion",0,0,0,"England",0,0,0,0,0,0,0,0,0,0,0,0,0,0,0,0,0,0,0,-1,-1,-1
"443","Nathan Redmond",27,"1994","03","06","2017/2018","Midfielder","Southampton",1945,944,1001,"England",31,14,17,1,0,1,3,2,1,0,0,8,3,5,29,12,17,3,0,218,91,-1
"444","Nathan Trott",22,"1998","11","21","2017/2018","Goalkeeper","West Ham United",0,0,0,"England",0,0,0,0,0,0,0,0,0,0,0,0,0,0,0,0,0,0,0,-1,-1,-1
"445","Nathaniel Chalobah",26,"1994","12","12","2017/2018","Midfielder","Watford",448,250,198,"England",6,3,3,0,0,0,0,0,0,0,0,3,1,2,7,7,0,1,0,343,290,-1
"446","Nathaniel Clyne",29,"1991","04","04","2017/2018","Defender","Liverpool",174,25,149,"England",3,1,2,0,0,0,0,0,0,0,0,2,1,1,1,0,1,1,0,-1,-1,-1
"447","Nemanja Matić",32,"1988","07","31","2017/2018","Midfielder","Manchester United",3119,1620,1499,"Serbia",36,18,18,1,0,1,1,1,0,0,0,17,11,6,25,9,16,6,0,236,235,-1
"448","Nick Pope",28,"1992","04","18","2017/2018","Goalkeeper","Burnley",3114,1584,1530,"England",35,18,17,0,0,0,0,0,0,0,0,12,7,5,30,12,18,3,0,303,269,37
"449","Nicolas Otamendi",33,"1988","02","12","2017/2018","Defender","Manchester City",2968,1502,1466,"Argentina",34,17,17,4,2,2,0,0,0,0,0,15,7,8,23,12,11,9,0,135,364,14
"450","Niki Mäenpää",36,"1985","01","23","2017/2018","Goalkeeper","Brighton & Hove Albion",0,0,0,"Finland",0,0,0,0,0,0,0,0,0,0,0,0,0,0,0,0,0,0,0,-1,-1,-1
"451","Nikola Vlašić",23,"1997","10","03","2017/2018","Midfielder","Everton",575,363,212,"Croatia",12,7,5,0,0,0,0,0,0,0,0,3,1,2,10,8,2,0,0,278,281,-1
"452","Nordin Amrabat",33,"1987","03","30","2017/2018","Midfielder","Watford",200,118,82,"Morocco",3,2,1,0,0,0,0,0,0,0,0,2,1,1,3,3,0,0,0,-1,-1,-1
"453","Nya Kirby",21,"2000","01","31","2017/2018","Midfielder","Crystal Palace",0,0,0,"England",0,0,0,0,0,0,0,0,0,0,0,0,0,0,0,0,0,0,0,-1,-1,-1
"454","Oleksandr Zinchenko",24,"1996","12","15","2017/2018","Midfielder","Manchester City",533,408,125,"Ukraine",8,5,3,0,0,0,0,0,0,0,0,5,2,3,3,3,0,1,0,264,295,-1
"455","Oliver Burke",23,"1997","04","06","2017/2018","Midfielder","West Bromwich Albion",356,236,120,"Scotland",15,9,6,0,0,0,2,1,1,0,0,1,1,0,9,5,4,0,0,270,2,-1
"456","Oliver McBurnie",24,"1996","06","03","2017/2018","Forward","Swansea City",269,39,230,"Scotland",11,3,8,0,0,0,1,0,1,0,0,2,0,2,5,2,3,0,0,-1,-1,-1
"457","Olivier Giroud",34,"1986","09","29","2017/2018","Forward","Chelsea",983,428,555,"France",29,14,15,7,4,3,1,1,0,0,0,10,7,3,9,0,9,0,0,7,152,-1
"458","Oluwatosin Adarabioyo",23,"1997","09","23","2017/2018","Defender","Manchester City",0,0,0,"England",0,0,0,0,0,0,0,0,0,0,0,0,0,0,0,0,0,0,0,-1,-1,-1
"459","Onyinye Wilfred Ndidi",24,"1996","12","16","2017/2018","Midfielder","Leicester City",2899,1411,1488,"Nigeria",33,16,17,0,0,0,3,1,2,0,0,9,6,3,43,16,27,10,2,337,145,-1
"460","Orestis Karnezis",35,"1985","07","10","2017/2018","Goalkeeper","Watford",1291,630,661,"Greece",15,7,8,0,0,0,0,0,0,0,0,4,3,1,20,5,15,0,0,277,282,106
"461","Oriol Romeu",29,"1991","09","23","2017/2018","Midfielder","Southampton",2903,1388,1515,"Spain",34,17,17,1,0,1,0,0,0,0,0,8,3,5,43,22,21,11,0,235,403,-1
"462","Oumar Niasse",30,"1990","04","17","2017/2018","Forward","Everton",1081,550,531,"Senegal",22,11,11,8,6,2,2,1,1,0,0,3,1,2,20,6,14,2,0,6,71,-1
"463","Pablo Zabaleta",36,"1985","01","16","2017/2018","Defender","West Ham United",3291,1620,1671,"Argentina",37,18,19,0,0,0,1,1,0,0,0,10,7,3,60,22,38,9,0,381,236,162
"464","Papa Alioune N'Diaye",30,"1990","10","26","2017/2018","Midfielder","Stoke City",1140,529,611,"Senegal",13,6,7,2,1,1,1,0,1,0,0,2,0,2,16,10,6,5,0,110,169,-1
"465","Pape N'Diaye Souaré",30,"1990","06","05","2017/2018","Defender","Crystal Palace",8,8,0,"Senegal",1,1,0,0,0,0,0,0,0,0,0,1,1,0,0,0,0,0,0,-1,-1,-1
"466","Pascal Groß",29,"1991","06","14","2017/2018","Midfielder","Brighton & Hove Albion",2949,1614,1335,"Germany",38,19,19,7,7,0,8,6,2,1,0,10,5,5,44,21,23,2,0,87,38,-1
"467","Patrice Evra",39,"1981","05","14","2017/2018","Defender","West Ham United",228,66,162,"France",5,1,4,0,0,0,0,0,0,0,0,1,0,1,10,4,6,0,0,-1,-1,-1
"468","Patrick van Aanholt",30,"1990","08","28","2017/2018","Defender","Crystal Palace",2185,1062,1123,"Netherlands",28,14,14,5,3,2,1,1,0,0,0,6,4,2,37,13,24,7,0,90,215,141
"469","Paul Dummett",29,"1991","09","25","2017/2018","Defender","Newcastle United",1603,875,728,"Wales",20,11,9,0,0,0,0,0,0,0,0,6,5,1,18,5,13,1,0,364,330,52
"470","Paul Pogba",28,"1993","03","15","2017/2018","Midfielder","Manchester United",2151,968,1183,"France",27,13,14,6,3,3,10,3,7,0,0,13,8,5,19,5,14,6,1,67,6,-1
"471","Paulo Dino Gazzaniga",29,"1992","01","02","2017/2018","Goalkeeper","Tottenham Hotspur",90,90,0,"Argentina",1,1,0,0,0,0,0,0,0,0,0,1,1,0,0,0,0,0,0,-1,-1,-1
"472","Pedro Obiang",28,"1992","03","27","2017/2018","Midfielder","West Ham United",1564,770,794,"Equatorial Guinea",21,10,11,2,1,1,0,0,0,0,0,5,3,2,27,13,14,3,0,137,371,-1
"473","Pedro Rodriguez",33,"1987","07","27","2017/2018","Midfielder","Chelsea",1522,739,783,"Spain",31,14,17,4,2,2,2,1,1,0,0,13,8,5,12,6,6,1,0,70,114,-1
"474","Per Mertesacker",36,"1984","09","28","2017/2018","Defender","Arsenal",365,103,262,"Germany",6,2,4,1,0,1,0,0,0,0,0,1,1,0,5,1,4,0,0,66,301,70
"475","Peter Crouch",40,"1981","01","30","2017/2018","Forward","Stoke City",1554,880,674,"England",31,16,15,5,2,3,2,2,0,0,0,4,2,2,25,15,10,4,0,57,111,-1
"476","Petr Čech",38,"1982","05","19","2017/2018","Goalkeeper","Arsenal",3040,1510,1530,"Czech Republic",34,17,17,0,0,0,0,0,0,0,0,11,8,3,45,19,26,1,0,298,412,89
"477","Phil Bardsley",35,"1985","06","27","2017/2018","Defender","Burnley",1126,496,630,"Scotland",13,6,7,0,0,0,0,0,0,0,0,4,2,2,11,6,5,5,0,273,256,39
"478","Phil Jagielka",38,"1982","08","16","2017/2018","Defender","Everton",2065,890,1175,"England",25,10,15,0,0,0,0,0,0,0,0,7,5,2,36,10,26,2,0,305,267,147
"479","Phil Jones",29,"1992","02","21","2017/2018","Defender","Manchester United",1975,810,1165,"England",23,9,14,0,0,0,0,0,0,0,0,15,8,7,10,2,8,2,0,377,399,4
"480","Philip Billing",24,"1996","06","10","2017/2018","Midfielder","Huddersfield Town",760,339,421,"Denmark",16,8,8,0,0,0,0,0,0,0,0,5,3,2,10,4,6,3,0,405,348,-1
"481","Philip Foden",20,"2000","05","27","2017/2018","Midfielder","Manchester City",44,36,8,"England",5,4,1,0,0,0,1,1,0,0,0,3,2,1,0,0,0,0,0,-1,-1,-1
"482","Philippe Coutinho",28,"1992","06","11","2017/2018","Midfielder","Liverpool",1116,596,520,"Brazil",14,8,6,7,2,5,6,2,4,0,0,5,4,1,14,3,11,0,0,14,3,-1
"483","Pierre-Emerick Aubameyang",31,"1989","06","17","2017/2018","Forward","Arsenal",1058,541,517,"Gabon",13,7,6,10,7,3,4,3,1,1,1,4,3,1,13,5,8,0,0,4,11,-1
"484","Pierre-Emile Højbjerg",25,"1995","08","04","2017/2018","Midfielder","Southampton",1671,716,955,"Denmark",23,10,13,0,0,0,0,0,0,0,0,3,0,3,27,10,17,6,0,281,293,-1
"485","Rafael Euclides Soares Camacho",20,"2000","05","21","2017/2018","Midfielder","Liverpool",0,0,0,"Portugal",0,0,0,0,0,0,0,0,0,0,0,0,0,0,0,0,0,0,0,-1,-1,-1
"486","Ragnar Klavan",35,"1985","10","30","2017/2018","Defender","Liverpool",1448,818,630,"Estonia",19,12,7,1,0,1,0,0,0,0,0,9,7,2,14,3,11,0,0,200,257,34
"487","Raheem Sterling",26,"1994","12","08","2017/2018","Forward","Manchester City",2592,1240,1352,"England",33,15,18,18,11,7,11,6,5,1,0,14,5,9,21,11,10,5,1,8,9,-1
"488","Rajiv van La Parra",29,"1991","06","03","2017/2018","Midfielder","Huddersfield Town",2145,1020,1125,"Netherlands",33,16,17,3,2,1,0,0,0,1,0,9,6,3,34,14,20,4,1,130,351,-1
"489","Ramadan Sobhi",24,"1997","01","23","2017/2018","Forward","Stoke City",1233,465,768,"Egypt",24,11,13,2,1,1,0,0,0,0,0,4,2,2,30,14,16,2,0,124,410,-1
"490","Rayhaan Rahim Amari Tulloch",20,"2001","01","20","2017/2018","Midfielder","West Bromwich Albion",0,0,0,"England",0,0,0,0,0,0,0,0,0,0,0,0,0,0,0,0,0,0,0,-1,-1,-1
"491","Reece Burke",24,"1996","09","01","2017/2018","Defender","West Ham United",0,0,0,"England",0,0,0,0,0,0,0,0,0,0,0,0,0,0,0,0,0,0,0,-1,-1,-1
"492","Reece Oxford",22,"1998","12","16","2017/2018","Defender","West Ham United",4,4,0,"England",1,1,0,0,0,0,0,0,0,0,0,0,0,0,0,0,0,0,0,-1,-1,-1
"493","Reiss Nelson",21,"1999","12","10","2017/2018","Forward","Arsenal",146,82,64,"England",3,2,1,0,0,0,0,0,0,0,0,0,0,0,3,2,1,0,0,-1,-1,-1
"494","Rekeem Harper",21,"2000","03","08","2017/2018","Midfielder","West Bromwich Albion",20,20,0,"England",1,1,0,0,0,0,0,0,0,0,0,1,1,0,0,0,0,0,0,-1,-1,-1
"495","Renato Sanches",23,"1997","08","17","2017/2018","Midfielder","Swansea City",704,313,391,"Portugal",12,5,7,0,0,0,0,0,0,0,0,2,1,1,8,4,4,1,0,280,309,-1
"496","Rhu-endly Martina",31,"1989","09","24","2017/2018","Defender","Everton",1830,1020,810,"Curaçao",21,12,9,0,0,0,2,1,1,0,0,6,4,2,29,11,18,1,0,309,132,116
"497","Richarlison de Andrade",23,"1997","05","09","2017/2018","Forward","Watford",2827,1265,1562,"Brazil",38,19,19,5,1,4,4,0,4,0,0,9,5,4,48,23,25,4,0,117,102,-1
"498","Riyad Mahrez",30,"1991","02","21","2017/2018","Midfielder","Leicester City",2960,1543,1417,"Algeria",36,18,18,12,6,6,10,4,6,0,0,9,6,3,48,18,30,2,0,37,18,-1
"499","Rob Elliot",34,"1986","04","29","2017/2018","Goalkeeper","Newcastle United",1440,720,720,"Republic of Ireland",16,8,8,0,0,0,0,0,0,0,0,3,2,1,20,8,12,0,0,362,327,73
"500","Rob Holding",25,"1995","09","19","2017/2018","Defender","Arsenal",820,365,455,"England",12,6,6,0,0,0,0,0,0,0,0,3,2,1,15,5,10,3,0,329,273,163
"501","Robbie Brady",29,"1992","01","14","2017/2018","Midfielder","Burnley",1279,618,661,"Republic of Ireland",15,7,8,1,0,1,2,1,1,0,0,6,4,2,11,2,9,3,0,181,92,-1
"502","Robert Green",41,"1980","01","18","2017/2018","Goalkeeper","Huddersfield Town",0,0,0,"England",0,0,0,0,0,0,0,0,0,0,0,0,0,0,0,0,0,0,0,-1,-1,-1
"503","Robert Kenedy Nunes do Nascimento",25,"1996","02","08","2017/2018","Midfielder","Newcastle United",1030,504,526,"Brazil",13,6,7,2,2,0,2,2,0,0,0,3,3,0,9,2,7,1,0,109,69,-1
"504","Roberto Firmino",29,"1991","10","01","2017/2018","Forward","Liverpool",2778,1456,1322,"Brazil",37,18,19,15,8,7,7,3,4,1,0,17,12,5,30,7,23,1,0,21,45,-1
"505","Roberto Maximiliano Pereyra",30,"1991","01","07","2017/2018","Forward","Watford",1622,890,732,"Argentina",32,17,15,5,4,1,2,2,0,0,0,6,4,2,30,16,14,3,0,61,120,-1
"506","Rolando Aarons",25,"1995","11","16","2017/2018","Midfielder","Newcastle United",137,87,50,"England",4,2,2,0,0,0,0,0,0,0,0,0,0,0,2,1,1,0,0,-1,-1,-1
"507","Romelu Lukaku",27,"1993","05","12","2017/2018","Forward","Manchester United",2869,1491,1378,"Belgium",34,18,16,16,10,6,7,4,3,0,1,16,11,5,25,8,17,4,0,19,52,-1
"508","Rondon",31,"1989","09","15","2017/2018","Forward","West Bromwich Albion",2772,1340,1432,"Venezuela",36,17,19,7,5,2,3,1,2,0,0,9,5,4,45,25,20,4,0,74,136,-1
"509","Roque Mesa",31,"1989","06","06","2017/2018","Midfielder","Swansea City",757,470,287,"Spain",11,6,5,0,0,0,0,0,0,0,0,2,2,0,13,6,7,3,0,327,336,-1
"510","Ross Barkley",27,"1993","12","05","2017/2018","Midfielder","Chelsea",131,54,77,"England",2,1,1,0,0,0,0,0,0,0,0,0,0,0,4,1,3,0,0,-1,-1,-1
"511","Ruben Loftus-Cheek",25,"1996","01","23","2017/2018","Midfielder","Crystal Palace",1875,961,914,"England",24,12,12,2,2,0,3,1,2,0,0,7,2,5,30,18,12,1,0,148,89,-1
"512","Ryan Bertrand",31,"1989","08","04","2017/2018","Defender","Southampton",3137,1607,1530,"England",35,18,17,0,0,0,4,4,0,0,0,7,3,4,46,24,22,2,0,318,121,87
"513","Ryan Fraser",27,"1994","02","24","2017/2018","Midfielder","AFC Bournemouth",2009,989,1020,"Scotland",26,14,12,5,4,1,3,2,1,0,0,3,2,1,36,15,21,0,0,77,104,-1
"514","Ryan Shawcross",33,"1987","10","03","2017/2018","Defender","Stoke City",2372,1260,1112,"England",27,14,13,1,0,1,1,0,1,0,0,5,3,2,38,20,18,2,0,226,220,118
"515","Sadio Mané",28,"1992","04","09","2017/2018","Forward","Liverpool",2207,1034,1173,"Senegal",29,14,15,10,6,4,7,3,4,0,0,12,8,4,18,5,13,4,1,30,20,-1
"516","Saido Berahino",27,"1993","08","03","2017/2018","Forward","Stoke City",484,274,210,"England",15,10,5,0,0,0,1,1,0,0,1,3,2,1,13,4,9,0,0,314,63,-1
"517","Sam Baldock",32,"1989","03","15","2017/2018","Forward","Brighton & Hove Albion",30,6,24,"England",2,1,1,0,0,0,0,0,0,0,0,0,0,0,0,0,0,0,0,-1,-1,-1
"518","Sam Byram",27,"1993","09","15","2017/2018","Defender","West Ham United",246,103,143,"England",5,3,2,0,0,0,0,0,0,0,0,1,1,0,7,1,6,1,0,-1,-1,-1
"519","Sam Clucas",30,"1990","09","24","2017/2018","Midfielder","Swansea City",2045,963,1082,"England",29,13,16,3,2,1,1,0,1,0,0,6,3,3,28,10,18,2,0,134,218,-1
"520","Sam Field",22,"1998","05","07","2017/2018","Midfielder","West Bromwich Albion",540,275,265,"England",10,4,6,1,1,0,0,0,0,0,0,3,2,1,6,4,2,3,0,106,328,-1
"521","Sam Hughes",23,"1997","04","14","2017/2018","Midfielder","Leicester City",0,0,0,"England",0,0,0,0,0,0,0,0,0,0,0,0,0,0,0,0,0,0,0,-1,-1,-1
"522","Sam McQueen",26,"1995","02","06","2017/2018","Defender","Southampton",142,13,129,"England",7,2,5,0,0,0,0,0,0,0,0,4,1,3,0,0,0,0,0,-1,-1,-1
"523","Sam Vokes",31,"1989","10","20","2017/2018","Forward","Burnley",978,429,549,"Wales",30,13,17,4,0,4,1,1,0,0,0,8,4,4,13,4,9,3,0,36,143,-1
"524","Sandro Ramirez",25,"1995","07","08","2017/2018","Forward","Everton",276,176,100,"Spain",8,5,3,0,0,0,0,0,0,0,0,2,2,0,6,2,4,0,0,308,385,-1
"525","Scott Arfield",32,"1988","11","01","2017/2018","Midfielder","Burnley",1336,556,780,"Canada",18,7,11,2,1,1,1,1,0,0,0,6,3,3,14,6,8,3,0,132,175,-1
"526","Scott Dann",34,"1987","02","14","2017/2018","Defender","Crystal Palace",1435,805,630,"England",17,10,7,1,1,0,0,0,0,0,0,2,1,1,26,16,10,4,0,203,359,157
"527","Scott Malone",29,"1991","03","25","2017/2018","Defender","Huddersfield Town",1115,586,529,"England",22,11,11,0,0,0,1,1,0,0,0,4,3,1,21,8,13,3,0,408,165,165
"528","Scott McTominay",24,"1996","12","08","2017/2018","Midfielder","Manchester United",629,457,172,"England",13,7,6,0,0,0,0,0,0,0,0,6,5,1,3,2,1,2,0,242,302,-1
"529","Sead Haksabanovic",21,"1999","05","03","2017/2018","Midfielder","West Ham United",0,0,0,"Montenegro",0,0,0,0,0,0,0,0,0,0,0,0,0,0,0,0,0,0,0,-1,-1,-1
"530","Sead Kolašinac",27,"1993","06","19","2017/2018","Defender","Arsenal",2151,1106,1045,"Bosnia and Herzegovina",27,14,13,2,2,0,4,4,0,0,0,10,7,3,27,13,14,3,0,167,70,61
"531","Séamus Coleman",32,"1988","10","10","2017/2018","Defender","Everton",1036,586,450,"Republic of Ireland",12,7,5,0,0,0,1,0,1,0,0,4,3,1,12,5,7,0,0,294,150,53
"532","Sebastian Prödl",33,"1987","06","20","2017/2018","Defender","Watford",1568,781,787,"Austria",21,11,10,0,0,0,0,0,0,0,0,6,3,3,25,13,12,5,0,344,286,117
"533","Serge Aurier",28,"1992","12","24","2017/2018","Defender","Tottenham Hotspur",1429,657,772,"Côte d'Ivoire",17,8,9,2,1,1,2,1,1,0,0,7,5,2,12,4,8,3,1,129,103,21
"534","Sergio Aguero",32,"1988","06","01","2017/2018","Forward","Manchester City",1969,1190,779,"Argentina",25,15,10,21,15,6,6,3,3,4,0,12,6,6,12,6,6,2,0,2,25,-1
"535","Sergio Germán Romero",34,"1987","02","22","2017/2018","Goalkeeper","Manchester United",90,90,0,"Argentina",1,1,0,0,0,0,0,0,0,0,0,1,1,0,0,0,0,0,0,-1,-1,-1
"536","Shane Duffy",29,"1992","01","01","2017/2018","Defender","Brighton & Hove Albion",3294,1603,1691,"Republic of Ireland",37,18,19,0,0,0,1,1,0,0,0,9,4,5,51,23,28,8,0,399,242,108
"537","Shane Long",34,"1987","01","22","2017/2018","Forward","Southampton",1577,647,930,"Republic of Ireland",30,14,16,2,1,1,1,0,1,0,0,7,2,5,25,10,15,6,0,145,187,-1
"538","Shinji Okazaki",34,"1986","04","15","2017/2018","Forward","Leicester City",1329,491,838,"Japan",27,12,15,6,2,4,2,1,1,0,0,8,5,3,18,5,13,2,0,29,90,-1
"539","Shkodran Mustafi",28,"1992","04","16","2017/2018","Defender","Arsenal",2273,1212,1061,"Germany",27,15,12,3,2,1,1,1,0,0,0,10,7,3,29,14,15,6,0,138,219,64
"540","Simon Francis",36,"1985","02","16","2017/2018","Defender","AFC Bournemouth",2706,1412,1294,"England",32,17,15,0,0,0,1,0,1,0,0,5,3,2,43,24,19,10,1,390,244,115
"541","Simon Mignolet",33,"1988","03","06","2017/2018","Goalkeeper","Liverpool",1710,720,990,"Belgium",19,8,11,0,0,0,0,0,0,0,0,7,5,2,22,3,19,3,0,346,311,65
"542","Sofiane Boufal",27,"1993","09","16","2017/2018","Midfielder","Southampton",1212,610,602,"Morocco",26,14,12,2,1,1,2,0,2,0,0,4,3,1,23,10,13,1,0,120,84,-1
"543","Solomon March",26,"1994","07","19","2017/2018","Midfielder","Brighton & Hove Albion",1841,806,1035,"England",36,18,18,1,0,1,1,1,0,0,0,10,5,5,27,10,17,3,0,208,198,-1
"544","Stefano Okaka",31,"1989","08","08","2017/2018","Forward","Watford",444,380,64,"Italy",15,10,5,1,1,0,1,1,0,0,0,3,3,0,7,4,3,2,0,97,60,-1
"545","Stephen Ireland",34,"1986","08","21","2017/2018","Midfielder","Stoke City",128,21,107,"Republic of Ireland",4,1,3,0,0,0,0,0,0,0,0,0,0,0,3,0,3,1,0,-1,-1,-1
"546","Stephen Ward",35,"1985","08","19","2017/2018","Defender","Burnley",2462,1292,1170,"Republic of Ireland",28,15,13,1,0,1,1,0,1,0,0,10,7,3,24,7,17,1,0,227,223,38
"547","Steve Cook",29,"1991","04","18","2017/2018","Defender","AFC Bournemouth",2766,1307,1459,"England",34,16,18,2,0,2,1,1,0,0,0,5,2,3,49,23,26,5,0,186,245,150
"548","Steve Mounié",26,"1994","09","28","2017/2018","Forward","Huddersfield Town",1857,998,859,"Benin",28,14,14,7,3,4,1,1,0,0,0,7,5,2,31,13,18,2,0,43,200,-1
"549","Steve Sidwell",38,"1982","12","14","2017/2018","Midfielder","Brighton & Hove Albion",0,0,0,"England",0,0,0,0,0,0,0,0,0,0,0,0,0,0,0,0,0,0,0,-1,-1,-1
"550","Steven Davis",36,"1985","01","01","2017/2018","Midfielder","Southampton",1521,920,601,"Northern Ireland",23,15,8,3,1,2,0,0,0,0,0,5,2,3,21,14,7,0,0,102,404,-1
"551","Steven Defour",32,"1988","04","14","2017/2018","Midfielder","Burnley",2009,1046,963,"Belgium",24,12,12,1,0,1,1,0,1,0,0,10,6,4,16,7,9,6,0,231,225,-1
"552","Stuart Taylor",40,"1980","11","28","2017/2018","Goalkeeper","Southampton",0,0,0,"England",0,0,0,0,0,0,0,0,0,0,0,0,0,0,0,0,0,0,0,-1,-1,-1
"553","Sullay Kaikai",25,"1995","08","25","2017/2018","Midfielder","Crystal Palace",13,0,13,"England",1,0,1,0,0,0,0,0,0,0,0,0,0,0,0,0,0,0,0,-1,-1,-1
"554","Sung-Yeung Ki",32,"1989","01","24","2017/2018","Midfielder","Swansea City",1869,1026,843,"South Korea",25,13,12,2,2,0,2,1,1,0,0,6,5,1,28,11,17,2,0,152,126,-1
"555","Tammy Abraham",23,"1997","10","01","2017/2018","Forward","Swansea City",1716,742,974,"England",31,15,16,5,3,2,1,0,1,0,0,8,4,4,27,10,17,0,0,65,205,-1
"556","Tashan Oakley-Boothe",21,"2000","02","14","2017/2018","Midfielder","Tottenham Hotspur",0,0,0,"England",0,0,0,0,0,0,0,0,0,0,0,0,0,0,0,0,0,0,0,-1,-1,-1
"557","Terence Kongolo",27,"1994","02","14","2017/2018","Defender","Huddersfield Town",1047,417,630,"Netherlands",13,6,7,0,0,0,0,0,0,0,0,2,1,1,14,6,8,0,0,251,259,67
"558","Theo Walcott",32,"1989","03","16","2017/2018","Forward","Everton",1216,650,566,"England",20,11,9,3,3,0,3,1,2,0,0,5,4,1,17,6,11,2,0,81,51,-1
"559","Thibaut Courtois",28,"1992","05","10","2017/2018","Goalkeeper","Chelsea",3150,1530,1620,"Belgium",35,17,18,0,0,0,0,0,0,0,0,15,10,5,30,11,19,2,0,351,255,32
"560","Thomas Edwards",22,"1999","01","22","2017/2018","Defender","Stoke City",483,180,303,"England",6,2,4,0,0,0,0,0,0,0,0,0,0,0,15,2,13,0,0,247,298,175
"561","Tiemoué Bakayoko",26,"1994","08","16","2017/2018","Midfielder","Chelsea",2124,801,1323,"France",29,13,16,2,0,2,2,1,1,0,0,14,8,6,17,6,11,5,1,171,164,-1
"562","Tim Krul",32,"1988","04","02","2017/2018","Goalkeeper","Brighton & Hove Albion",0,0,0,"Netherlands",0,0,0,0,0,0,0,0,0,0,0,0,0,0,0,0,0,0,0,-1,-1,-1
"563","Timothy Fosu-Mensah",23,"1998","01","02","2017/2018","Defender","Crystal Palace",1594,874,720,"Netherlands",21,13,8,0,0,0,0,0,0,0,0,2,2,0,29,12,17,2,0,396,357,159
"564","Toby Alderweireld",32,"1989","03","02","2017/2018","Defender","Tottenham Hotspur",1177,547,630,"Belgium",14,7,7,0,0,0,0,0,0,0,0,6,3,3,11,7,4,3,0,369,366,29
"565","Tom Carroll",28,"1992","05","27","2017/2018","Midfielder","Swansea City",2569,1232,1337,"England",37,19,18,0,0,0,4,3,1,0,0,9,5,4,37,16,21,3,0,354,94,-1
"566","Tom Cleverley",31,"1989","08","11","2017/2018","Midfielder","Watford",1905,907,998,"England",23,11,12,1,1,0,2,1,1,0,1,6,2,4,28,17,11,3,1,213,148,-1
"567","Tom Davies",22,"1998","06","29","2017/2018","Midfielder","Everton",1899,1089,810,"England",33,18,15,2,2,0,1,1,0,0,0,10,7,3,21,9,12,7,0,164,203,-1
"568","Tom Heaton",34,"1986","04","14","2017/2018","Goalkeeper","Burnley",306,126,180,"England",4,2,2,0,0,0,0,0,0,0,0,1,1,0,4,1,3,0,0,341,251,66
"569","Tom Ince",29,"1992","01","30","2017/2018","Midfielder","Huddersfield Town",2456,1350,1106,"England",33,18,15,2,2,0,0,0,0,0,0,9,7,2,37,17,20,0,0,187,347,-1
"570","Tom Smith",28,"1992","04","13","2017/2018","Defender","Huddersfield Town",1907,925,982,"England",24,11,13,0,0,0,1,0,1,0,0,7,4,3,30,15,15,7,0,404,196,114
"571","Tomer Hemed",33,"1987","05","01","2017/2018","Forward","Brighton & Hove Albion",848,420,428,"Israel",16,7,9,2,2,0,2,2,0,0,0,7,4,3,8,3,5,0,0,89,53,-1
"572","Trent Alexander-Arnold",22,"1998","10","06","2017/2018","Defender","Liverpool",1576,865,711,"England",19,10,9,1,1,0,1,1,0,0,0,9,7,2,15,3,12,3,0,202,180,31
"573","Trevoh Chalobah",21,"1999","07","04","2017/2018","Defender","Chelsea",0,0,0,"England",0,0,0,0,0,0,0,0,0,0,0,0,0,0,0,0,0,0,0,-1,-1,-1
"574","Troy Deeney",32,"1988","06","28","2017/2018","Forward","Watford",1841,927,914,"England",29,15,14,5,5,0,2,1,1,3,2,6,4,2,26,12,14,2,1,68,128,-1
"575","Tyrese Campbell",21,"1999","12","28","2017/2018","Forward","Stoke City",75,49,26,"England",4,3,1,0,0,0,0,0,0,0,0,0,0,0,2,1,1,0,0,-1,-1,-1
"576","Tyrone Mings",28,"1993","03","13","2017/2018","Defender","AFC Bournemouth",202,90,112,"England",4,2,2,0,0,0,0,0,0,0,0,1,1,0,4,1,3,1,0,-1,-1,-1
"577","Uwe Hünemeier",35,"1986","01","09","2017/2018","Defender","Brighton & Hove Albion",17,17,0,"Germany",1,1,0,0,0,0,0,0,0,0,0,0,0,0,0,0,0,0,0,-1,-1,-1
"578","Vicente Iborra De La Fuente",33,"1988","01","16","2017/2018","Midfielder","Leicester City",1415,675,740,"Spain",19,9,10,3,0,3,0,0,0,0,0,5,2,3,23,10,13,0,0,100,300,-1
"579","Victor Moses",30,"1990","12","12","2017/2018","Midfielder","Chelsea",2118,941,1177,"Nigeria",28,12,16,3,1,2,3,3,0,0,0,13,9,4,18,5,13,3,0,133,106,-1
"580","Victor Nilsson Lindelöf",26,"1994","07","16","2017/2018","Defender","Manchester United",1281,674,607,"Sweden",17,8,9,0,0,0,0,0,0,0,0,6,3,3,13,5,8,1,0,243,380,44
"581","Victor Wanyama",29,"1991","06","24","2017/2018","Midfielder","Tottenham Hotspur",838,332,506,"Kenya",18,8,10,1,0,1,0,0,0,0,0,8,5,3,9,6,3,2,0,144,395,-1
"582","Vincent Janssen",26,"1994","06","14","2017/2018","Forward","Tottenham Hotspur",0,0,0,"Netherlands",1,1,0,0,0,0,0,0,0,0,0,0,0,0,0,0,0,0,0,-1,-1,-1
"583","Vincent Kompany",34,"1986","04","09","2017/2018","Defender","Manchester City",1397,540,857,"Belgium",17,6,11,1,1,0,1,0,1,0,0,7,2,5,12,6,6,6,0,205,176,22
"584","Virgil van Dijk",29,"1991","07","07","2017/2018","Defender","Liverpool",2253,1170,1083,"Netherlands",26,13,13,0,0,0,0,0,0,0,0,9,6,3,26,11,15,1,0,292,312,54
"585","Wayne Hennessey",34,"1987","01","24","2017/2018","Goalkeeper","Crystal Palace",2430,1170,1260,"Wales",27,13,14,0,0,0,0,0,0,0,0,7,4,3,40,15,25,1,0,393,363,131
"586","Wayne Rooney",35,"1985","10","23","2017/2018","Forward","Everton",2283,1213,1070,"England",31,17,14,10,6,4,2,2,0,3,3,8,6,2,32,15,17,5,0,32,166,-1
"587","Wayne Routledge",36,"1985","01","07","2017/2018","Midfielder","Swansea City",421,180,241,"England",15,8,7,0,0,0,0,0,0,0,0,4,1,3,11,6,5,1,0,323,391,-1
"588","Wes Morgan",37,"1984","01","21","2017/2018","Defender","Leicester City",2818,1378,1440,"Jamaica",32,16,16,0,0,0,0,0,0,0,0,6,4,2,50,20,30,4,0,335,306,152
"589","Wesley Hoedt",27,"1994","03","06","2017/2018","Defender","Southampton",2520,990,1530,"Netherlands",28,11,17,0,0,0,1,1,0,0,0,5,1,4,38,13,25,7,0,267,224,94
"590","Wilfredo Daniel Caballero",39,"1981","09","27","2017/2018","Goalkeeper","Chelsea",270,180,90,"Argentina",3,2,1,0,0,0,0,0,0,0,0,1,0,1,4,4,0,0,0,-1,-1,-1
"591","Wilfried Guemiand Bony",32,"1988","12","10","2017/2018","Forward","Swansea City",704,373,331,"Côte d'Ivoire",15,7,8,2,1,1,0,0,0,0,0,4,3,1,8,5,3,2,0,64,310,-1
"592","Wilfried Zaha",28,"1992","11","10","2017/2018","Midfielder","Crystal Palace",2550,1350,1200,"Côte d'Ivoire",29,15,14,9,7,2,3,2,1,0,0,9,4,5,31,20,11,5,0,49,119,-1
"593","Will Hughes",25,"1995","04","16","2017/2018","Midfielder","Watford",995,505,490,"England",15,8,7,2,1,1,3,3,0,0,0,4,3,1,15,7,8,0,0,104,28,-1
"594","Willian",32,"1988","08","08","2017/2018","Forward","Chelsea",1883,1026,857,"Brazil",36,18,18,6,2,4,7,3,4,1,0,16,10,6,16,9,7,1,0,55,12,-1
"595","Winston Reid",32,"1988","07","02","2017/2018","Defender","West Ham United",1454,900,554,"New Zealand",17,10,7,0,0,0,0,0,0,0,0,5,4,1,26,15,11,5,0,382,379,154
"596","Xherdan Shaqiri",29,"1991","10","09","2017/2018","Midfielder","Stoke City",3049,1494,1555,"Switzerland",36,18,18,8,4,4,7,4,3,0,1,6,3,3,56,26,30,5,0,71,54,-1
"597","Yannick Bolasie Yala",31,"1989","05","23","2017/2018","Forward","Everton",855,440,415,"Congo DR",16,7,9,1,1,0,0,0,0,0,0,4,3,1,14,4,10,0,0,142,308,-1
"598","Yohan Benalouane",33,"1987","03","28","2017/2018","Defender","Leicester City",90,90,0,"Tunisia",1,1,0,0,0,0,0,0,0,0,0,0,0,0,2,2,0,0,0,-1,-1,-1
"599","Yohan Cabaye",35,"1986","01","14","2017/2018","Midfielder","Crystal Palace",2388,1157,1231,"France",31,15,16,0,0,0,1,1,0,0,0,7,3,4,36,15,21,7,0,244,221,-1
"600","Younes Kaboul",35,"1986","01","04","2017/2018","Defender","Watford",151,90,61,"France",2,1,1,0,0,0,0,0,0,0,0,1,0,1,3,3,0,0,0,-1,-1,-1
"601","Zlatan Ibrahimović",39,"1981","10","02","2017/2018","Forward","Manchester United",103,101,2,"Sweden",5,4,1,0,0,0,0,0,0,0,0,1,1,0,2,2,0,0,0,-1,-1,-1
"602","Łukasz Fabiański",35,"1985","04","17","2017/2018","Goalkeeper","Swansea City",3420,1710,1710,"Poland",38,19,19,0,0,0,0,0,0,0,0,9,5,4,53,23,30,0,0,320,393,102
"603","Aaron Cresswell",31,"1989","12","15","2018/2019","Defender","West Ham United",1589,888,701,"England",20,11,9,0,0,0,1,1,0,0,0,3,2,1,22,12,10,1,0,290,191,80
"604","Aaron Lennon",33,"1987","04","16","2018/2019","Midfielder","Burnley",1217,487,730,"England",16,7,9,1,1,0,1,1,0,0,0,4,2,2,20,8,12,1,0,196,187,-1
"605","Aaron Mooy",30,"1990","09","15","2018/2019","Midfielder","Huddersfield Town",2327,1190,1137,"Australia",29,15,14,3,1,2,1,0,1,1,0,4,3,1,46,20,26,4,0,144,233,-1
"606","Aaron Ramsey",30,"1990","12","26","2018/2019","Midfielder","Arsenal",1327,689,638,"Wales",28,14,14,4,2,2,6,5,1,0,0,7,6,1,12,2,10,0,0,69,8,-1
"607","Aaron Rowe",20,"2000","09","07","2018/2019","Forward","Huddersfield Town",69,14,55,"England",2,1,1,0,0,0,0,0,0,0,0,0,0,0,1,0,1,0,0,-1,-1,-1
"608","Aaron Wan-Bissaka",23,"1997","11","26","2018/2019","Midfielder","Crystal Palace",3135,1605,1530,"England",35,18,17,0,0,0,3,1,2,0,0,12,7,5,41,17,24,5,1,312,160,-1
"609","Abdelhamid Sabiri",24,"1996","11","28","2018/2019","Midfielder","Huddersfield Town",49,0,49,"Morocco",2,0,2,0,0,0,0,0,0,0,0,0,0,0,3,0,3,0,0,-1,-1,-1
"610","Abdoulaye Doucouré",28,"1993","01","01","2018/2019","Midfielder","Watford",3062,1566,1496,"France",35,18,17,5,3,2,6,2,4,0,0,5,3,2,54,27,27,7,0,124,80,-1
"611","Aboubakar Kamara",26,"1995","03","07","2018/2019","Forward","Fulham",687,468,219,"France",13,8,5,3,1,2,0,0,0,1,1,2,1,1,16,9,7,2,0,38,412,-1
"612","Adalberto Peñaranda Maestre",23,"1997","05","31","2018/2019","Forward","Watford",0,0,0,"Venezuela",0,0,0,0,0,0,0,0,0,0,0,0,0,0,0,0,0,0,0,-1,-1,-1
"613","Adam David Lallana",32,"1988","05","10","2018/2019","Midfielder","Liverpool",465,189,276,"England",13,6,7,0,0,0,0,0,0,0,0,6,1,5,2,1,1,1,0,379,344,-1
"614","Adam Masina",27,"1994","01","02","2018/2019","Defender","Watford",1003,463,540,"Italy",14,7,7,0,0,0,1,1,0,0,0,2,1,1,19,8,11,5,0,397,155,144
"615","Adam Smith",29,"1991","04","29","2018/2019","Defender","AFC Bournemouth",2073,1051,1022,"England",25,12,13,1,1,0,1,0,1,0,0,9,5,4,30,10,20,6,1,227,228,85
"616","Adama Diakhaby",24,"1996","07","05","2018/2019","Forward","Huddersfield Town",551,345,206,"France",12,8,4,0,0,0,0,0,0,0,0,1,1,0,16,7,9,1,0,332,359,-1
"617","Adama Traoré Diarra",25,"1996","01","25","2018/2019","Midfielder","Wolverhampton Wanderers",890,315,575,"Spain",29,12,17,1,0,1,1,1,0,0,0,6,4,2,11,2,9,1,0,160,152,-1
"618","Ademola Lookman",23,"1997","10","20","2018/2019","Forward","Everton",601,334,267,"England",21,11,10,0,0,0,2,2,0,0,0,8,5,3,7,2,5,0,0,292,20,-1
"619","Adrian Mariappa",34,"1986","10","03","2018/2019","Defender","Watford",1921,841,1080,"Jamaica",26,12,14,0,0,0,0,0,0,0,0,6,3,3,29,10,19,3,0,396,414,94
"620","Adrián San Miguel del Castillo",34,"1987","01","03","2018/2019","Goalkeeper","West Ham United",0,0,0,"Spain",0,0,0,0,0,0,0,0,0,0,0,0,0,0,0,0,0,0,0,-1,-1,-1
"621","Adrien Sebastian Perruchet Silva",32,"1989","03","15","2018/2019","Midfielder","Leicester City",88,8,80,"Portugal",2,1,1,0,0,0,0,0,0,0,0,1,1,0,1,0,1,0,0,-1,-1,-1
"622","Ainsley Maitland-Niles",23,"1997","08","29","2018/2019","Midfielder","Arsenal",985,462,523,"England",16,7,9,1,0,1,1,0,1,0,0,4,3,1,16,5,11,3,1,174,167,-1
"623","Alberto Moreno",28,"1992","07","05","2018/2019","Defender","Liverpool",155,90,65,"Spain",2,1,1,0,0,0,0,0,0,0,0,0,0,0,2,1,1,0,0,-1,-1,-1
"624","Aleksandar Mitrović",26,"1994","09","16","2018/2019","Forward","Fulham",3282,1616,1666,"Serbia",37,18,19,11,8,3,3,2,1,1,0,5,3,2,74,31,43,7,0,62,176,-1
"625","Alex Iwobi",24,"1996","05","03","2018/2019","Forward","Arsenal",1972,742,1230,"Nigeria",35,18,17,3,1,2,6,3,3,0,0,8,7,1,31,8,23,0,0,128,31,-1
"626","Alex McCarthy",31,"1989","12","03","2018/2019","Goalkeeper","Southampton",2250,1170,1080,"England",25,13,12,0,0,0,0,0,0,0,0,4,2,2,37,16,21,1,0,372,365,114
"627","Alex Oxlade-Chamberlain",27,"1993","08","15","2018/2019","Midfielder","Liverpool",19,19,0,"England",2,2,0,0,0,0,0,0,0,0,0,2,2,0,0,0,0,0,0,-1,-1,-1
"628","Alex Pritchard",27,"1993","05","03","2018/2019","Midfielder","Huddersfield Town",2092,992,1100,"England",30,14,16,2,1,1,0,0,0,0,0,4,2,2,39,16,23,2,0,171,373,-1
"629","Alex Smithies",31,"1990","03","05","2018/2019","Goalkeeper","Cardiff City",0,0,0,"England",0,0,0,0,0,0,0,0,0,0,0,0,0,0,0,0,0,0,0,-1,-1,-1
"630","Alexander Sørloth",25,"1995","12","05","2018/2019","Forward","Crystal Palace",173,121,52,"Norway",12,8,4,0,0,0,0,0,0,0,0,4,3,1,1,0,1,0,0,-1,-1,-1
"631","Alexandre Lacazette",29,"1991","05","28","2018/2019","Forward","Arsenal",2503,1403,1100,"France",35,19,16,13,9,4,8,4,4,0,0,7,7,0,28,10,18,2,0,21,25,-1
"632","Alexandre Nascimento Costa Silva",24,"1997","03","16","2018/2019","Forward","West Ham United",17,0,17,"Portugal",1,0,1,0,0,0,0,0,0,0,0,0,0,0,0,0,0,0,0,-1,-1,-1
"633","Alexis Sanchez",32,"1988","12","19","2018/2019","Forward","Manchester United",877,387,490,"Chile",20,10,10,1,1,0,3,0,3,0,0,6,2,4,8,4,4,3,0,166,17,-1
"634","Alfie Jones",23,"1997","10","07","2018/2019","Defender","Southampton",0,0,0,"England",0,0,0,0,0,0,0,0,0,0,0,0,0,0,0,0,0,0,0,-1,-1,-1
"635","Alfie Mawson",27,"1994","01","19","2018/2019","Defender","Fulham",1131,547,584,"England",15,8,7,0,0,0,0,0,0,0,0,3,2,1,25,10,15,2,0,307,255,161
"636","Alfie Whiteman",22,"1998","10","02","2018/2019","Goalkeeper","Tottenham Hotspur",0,0,0,"England",0,0,0,0,0,0,0,0,0,0,0,0,0,0,0,0,0,0,0,-1,-1,-1
"637","Ali Koiki",20,"2000","08","22","2018/2019","Defender","Burnley",0,0,0,"England",0,0,0,0,0,0,0,0,0,0,0,0,0,0,0,0,0,0,0,-1,-1,-1
"638","Alireza Jahanbakhsh",27,"1993","08","11","2018/2019","Forward","Brighton & Hove Albion",1022,494,528,"Iran",19,9,10,0,0,0,0,0,0,0,0,4,3,1,16,8,8,2,0,403,270,-1
"639","Alisson Becker",28,"1992","10","02","2018/2019","Goalkeeper","Liverpool",3420,1710,1710,"Brazil",38,19,19,0,0,0,0,0,0,0,0,21,12,9,19,8,11,1,0,417,387,3
"640","Alvaro Morata",28,"1992","10","23","2018/2019","Forward","Chelsea",943,530,413,"Spain",16,8,8,5,3,2,0,0,0,0,0,9,4,5,11,6,5,3,0,20,338,-1
"641","Ander Herrera",31,"1989","08","14","2018/2019","Midfielder","Manchester United",1404,617,787,"Spain",22,10,12,2,0,2,3,3,0,0,0,6,1,5,17,9,8,4,0,134,68,-1
"642","André Filipe Tavares Gomes",27,"1993","07","30","2018/2019","Midfielder","Everton",1986,972,1014,"Portugal",27,13,14,1,1,0,1,1,0,0,0,10,6,4,27,13,14,7,0,220,213,-1
"643","Andre Gray",29,"1991","06","26","2018/2019","Forward","Watford",1358,809,549,"England",29,15,14,7,5,2,2,2,0,0,0,5,3,2,23,16,7,2,0,25,109,-1
"644","André Schürrle",30,"1990","11","06","2018/2019","Midfielder","Fulham",1650,829,821,"Germany",24,12,12,6,3,3,0,0,0,0,0,1,0,1,42,20,22,2,0,54,417,-1
"645","André-Frank Zambo Anguissa",25,"1995","11","16","2018/2019","Midfielder","Fulham",1518,587,931,"Cameroon",22,10,12,0,0,0,0,0,0,0,0,3,2,1,30,10,20,3,1,288,285,-1
"646","Andreas Christensen",24,"1996","04","10","2018/2019","Defender","Chelsea",615,360,255,"Denmark",8,4,4,0,0,0,0,0,0,0,0,3,3,0,7,2,5,1,0,338,346,35
"647","Andreas Pereira",25,"1996","01","01","2018/2019","Midfielder","Manchester United",595,521,74,"Brazil",15,10,5,1,1,0,1,1,0,0,0,1,1,0,10,7,3,5,0,117,93,-1
"648","Andrew Robertson",27,"1994","03","11","2018/2019","Defender","Liverpool",3219,1599,1620,"Scotland",36,18,18,0,0,0,11,9,2,0,0,21,12,9,17,7,10,4,0,418,19,2
"649","Andrew Surman",34,"1986","08","20","2018/2019","Midfielder","AFC Bournemouth",1438,526,912,"England",18,7,11,0,0,0,0,0,0,0,0,5,3,2,35,7,28,2,0,359,379,-1
"650","Andriy Yarmolenko",31,"1989","10","23","2018/2019","Forward","West Ham United",459,269,190,"Ukraine",9,5,4,2,0,2,0,0,0,0,0,1,1,0,4,1,3,2,0,36,361,-1
"651","Andros Townsend",29,"1991","07","16","2018/2019","Midfielder","Crystal Palace",3018,1571,1447,"England",38,19,19,6,2,4,4,2,2,0,0,12,7,5,44,20,24,1,0,102,127,-1
"652","Andy Carroll",32,"1989","01","06","2018/2019","Forward","West Ham United",454,180,274,"England",12,6,6,0,0,0,0,0,0,0,0,2,1,1,6,2,4,2,0,270,326,-1
"653","Angel Gomes",20,"2000","08","31","2018/2019","Midfielder","Manchester United",25,25,0,"England",2,2,0,0,0,0,0,0,0,0,0,0,0,0,1,1,0,0,0,-1,-1,-1
"654","Angelo Ogbonna",32,"1988","05","23","2018/2019","Defender","West Ham United",1870,956,914,"Italy",24,12,12,1,1,0,1,1,0,0,0,3,2,1,32,13,19,2,0,226,207,124
"655","Angus Gunn",25,"1996","01","22","2018/2019","Goalkeeper","Southampton",1080,540,540,"England",12,6,6,0,0,0,0,0,0,0,0,3,1,2,17,9,8,0,0,376,339,104
"656","Anthony Driscoll-Glennon",21,"1999","11","26","2018/2019","Defender","Burnley",0,0,0,"England",0,0,0,0,0,0,0,0,0,0,0,0,0,0,0,0,0,0,0,-1,-1,-1
"657","Anthony Knockaert",29,"1991","11","20","2018/2019","Midfielder","Brighton & Hove Albion",1832,982,850,"France",30,16,14,2,1,1,6,5,1,0,0,3,3,0,36,17,19,5,1,159,27,-1
"658","Anthony Martial",25,"1995","12","05","2018/2019","Forward","Manchester United",1623,743,880,"France",27,11,16,10,4,6,2,1,1,1,0,5,1,4,25,8,17,2,0,13,141,-1
"659","Antonio Barreca",26,"1995","03","18","2018/2019","Defender","Newcastle United",4,0,4,"Italy",1,0,1,0,0,0,0,0,0,0,0,0,0,0,0,0,0,0,0,-1,-1,-1
"660","Antonio Rüdiger",28,"1993","03","03","2018/2019","Defender","Chelsea",2874,1350,1524,"Germany",33,15,18,1,1,0,0,0,0,0,0,12,7,5,34,10,24,7,0,259,374,38
"661","Antonio Valencia",35,"1985","08","04","2018/2019","Defender","Manchester United",466,196,270,"Ecuador",6,3,3,0,0,0,0,0,0,0,0,2,0,2,5,4,1,2,0,300,256,29
"662","Arijanet Muric",22,"1998","11","07","2018/2019","Goalkeeper","Manchester City",0,0,0,"Montenegro",0,0,0,0,0,0,0,0,0,0,0,0,0,0,0,0,0,0,0,-1,-1,-1
"663","Aron Einar Gunnarsson",31,"1989","04","22","2018/2019","Midfielder","Cardiff City",2274,1240,1034,"Iceland",28,14,14,1,1,0,1,1,0,0,0,8,4,4,37,20,17,5,0,232,234,-1
"664","Arthur Masuaku",27,"1993","11","07","2018/2019","Defender","West Ham United",1756,822,934,"France",23,11,12,0,0,0,1,1,0,0,0,6,3,3,26,11,15,2,0,368,203,89
"665","Artur Boruc",41,"1980","02","20","2018/2019","Goalkeeper","AFC Bournemouth",1080,540,540,"Poland",12,6,6,0,0,0,0,0,0,0,0,4,2,2,17,4,13,2,0,361,394,100
"666","Ashley Barnes",31,"1989","10","30","2018/2019","Forward","Burnley",2400,1307,1093,"England",37,19,18,12,6,6,2,1,1,2,0,8,5,3,34,16,18,8,0,27,172,-1
"667","Ashley Westwood",31,"1990","04","01","2018/2019","Midfielder","Burnley",2822,1530,1292,"England",34,18,16,2,0,2,7,2,5,0,0,7,5,2,44,22,22,5,0,212,55,-1
"668","Ashley Young",35,"1985","07","09","2018/2019","Midfielder","Manchester United",2568,1207,1361,"England",30,14,16,2,1,1,2,2,0,0,0,4,2,2,41,16,25,10,1,195,181,-1
"669","Asmir Begović",33,"1987","06","20","2018/2019","Goalkeeper","AFC Bournemouth",2160,1080,1080,"Bosnia and Herzegovina",24,12,12,0,0,0,0,0,0,0,0,5,3,2,44,19,25,0,0,358,273,154
"670","Aymeric Laporte",26,"1994","05","27","2018/2019","Defender","Manchester City",3057,1526,1531,"France",35,17,18,3,0,3,3,3,0,0,0,18,8,10,21,11,10,3,0,176,158,14
"671","Ayoze Perez",27,"1993","07","29","2018/2019","Forward","Newcastle United",2929,1526,1403,"Spain",37,19,18,12,9,3,2,1,1,0,0,11,5,6,34,21,13,2,0,44,197,-1
"672","Bakary Sako",32,"1988","04","26","2018/2019","Midfielder","Crystal Palace",25,8,17,"Mali",4,3,1,0,0,0,0,0,0,0,0,1,1,0,0,0,0,0,0,-1,-1,-1
"673","Bakayo Sako",0,"1970","01","01","2018/2019","Midfielder","Arsenal",7,7,0,"England",1,1,0,0,0,0,0,0,0,0,0,0,0,0,0,0,0,0,0,-1,-1,-1
"674","Ben Chilwell",24,"1996","12","21","2018/2019","Defender","Leicester City",3240,1620,1620,"England",36,18,18,0,0,0,4,1,3,0,0,10,6,4,39,15,24,4,0,344,139,44
"675","Ben Davies",27,"1993","04","24","2018/2019","Defender","Tottenham Hotspur",1839,916,923,"Wales",27,13,14,0,0,0,0,0,0,0,0,10,6,4,24,10,14,2,0,353,274,60
"676","Ben Foster",37,"1983","04","03","2018/2019","Goalkeeper","Watford",3420,1710,1710,"England",38,19,19,0,0,0,0,0,0,0,0,7,4,3,57,28,29,1,0,365,353,116
"677","Ben Gibson",28,"1993","01","15","2018/2019","Defender","Burnley",63,63,0,"England",1,1,0,1,1,0,0,0,0,0,0,0,0,0,3,3,0,1,0,-1,-1,-1
"678","Ben Hamer",33,"1987","11","20","2018/2019","Goalkeeper","Huddersfield Town",553,283,270,"England",7,4,3,0,0,0,0,0,0,0,0,1,1,0,20,9,11,0,0,327,348,175
"679","Ben Mee",31,"1989","09","21","2018/2019","Defender","Burnley",3420,1710,1710,"England",38,19,19,0,0,0,2,1,1,0,0,8,5,3,57,27,30,9,0,380,211,118
"680","Ben White",23,"1997","10","08","2018/2019","Defender","Brighton & Hove Albion",0,0,0,"England",0,0,0,0,0,0,0,0,0,0,0,0,0,0,0,0,0,0,0,-1,-1,-1
"681","Ben Wilmot",21,"1999","11","04","2018/2019","Defender","Watford",26,0,26,"England",2,0,2,0,0,0,0,0,0,0,0,1,0,1,2,0,2,0,0,-1,-1,-1
"682","Benjamin Johnson",21,"2000","01","24","2018/2019","Forward","West Ham United",63,0,63,"England",1,0,1,0,0,0,0,0,0,0,0,0,0,0,1,0,1,0,0,-1,-1,-1
"683","Benjamin Mendy",26,"1994","07","17","2018/2019","Defender","Manchester City",900,450,450,"France",10,5,5,0,0,0,5,3,2,0,0,4,1,3,6,4,2,1,0,311,3,12
"684","Beram Kayal",32,"1988","05","02","2018/2019","Midfielder","Brighton & Hove Albion",934,494,440,"Israel",18,9,9,1,0,1,1,1,0,0,0,5,3,2,15,8,7,4,0,163,146,-1
"685","Bernard Anício Caldeira Duarte",28,"1992","09","08","2018/2019","Midfielder","Everton",2128,960,1168,"Brazil",34,16,18,1,0,1,3,1,2,0,0,14,9,5,19,5,14,5,0,243,117,-1
"686","Bernardo",25,"1995","05","14","2018/2019","Defender","Brighton & Hove Albion",1750,990,760,"Brazil",22,11,11,0,0,0,1,1,0,0,0,4,2,2,28,17,11,4,0,400,200,107
"687","Bernardo Silva",26,"1994","08","10","2018/2019","Midfielder","Manchester City",2853,1470,1383,"Portugal",36,18,18,7,2,5,7,4,3,0,0,18,8,10,22,11,11,3,0,85,58,-1
"688","Bernd Leno",29,"1992","03","04","2018/2019","Goalkeeper","Arsenal",2835,1395,1440,"Germany",32,16,16,0,0,0,0,0,0,0,0,7,6,1,39,12,27,0,0,390,413,76
"689","Bobby Reid",28,"1993","02","02","2018/2019","Midfielder","Cardiff City",1422,725,697,"England",27,11,16,5,4,1,2,1,1,1,0,6,2,4,27,19,8,0,0,55,115,-1
"690","Brian Murphy",37,"1983","05","07","2018/2019","Goalkeeper","Cardiff City",0,0,0,"Republic of Ireland",0,0,0,0,0,0,0,0,0,0,0,0,0,0,0,0,0,0,0,-1,-1,-1
"691","Bright Enobakhare",23,"1998","02","08","2018/2019","Forward","Wolverhampton Wanderers",0,0,0,"England",0,0,0,0,0,0,0,0,0,0,0,0,0,0,0,0,0,0,0,-1,-1,-1
"692","Bruno Écuélé Manga",32,"1988","07","16","2018/2019","Defender","Cardiff City",3375,1710,1665,"Gabon",38,19,19,0,0,0,1,1,0,0,0,10,5,5,59,34,25,0,0,337,242,126
"693","Bruno Saltor Grau",40,"1980","10","01","2018/2019","Defender","Brighton & Hove Albion",1136,534,602,"Spain",14,6,8,0,0,0,1,1,0,0,0,4,2,2,17,8,9,2,0,399,175,92
"694","Caglar Söyüncü",24,"1996","05","23","2018/2019","Defender","Leicester City",371,191,180,"Turkey",6,4,2,0,0,0,0,0,0,0,0,2,2,0,3,1,2,1,0,267,330,16
"695","Callum Hudson-Odoi",20,"2000","11","07","2018/2019","Midfielder","Chelsea",391,267,124,"England",10,6,4,0,0,0,1,1,0,0,0,3,3,0,5,2,3,0,0,277,54,-1
"696","Callum Paterson",26,"1994","10","13","2018/2019","Defender","Cardiff City",1996,1024,972,"Scotland",27,14,13,4,3,1,1,0,1,0,0,7,5,2,37,18,19,4,0,108,202,137
"697","Callum Roberts",23,"1997","04","14","2018/2019","Forward","Newcastle United",0,0,0,"England",0,0,0,0,0,0,0,0,0,0,0,0,0,0,0,0,0,0,0,-1,-1,-1
"698","Callum Slattery",22,"1999","02","08","2018/2019","Midfielder","Southampton",110,6,104,"England",3,1,2,0,0,0,0,0,0,0,0,0,0,0,0,0,0,0,0,-1,-1,-1
"699","Callum Wilson",29,"1992","02","27","2018/2019","Forward","AFC Bournemouth",2535,1324,1211,"England",30,15,15,14,5,9,9,4,5,1,1,9,5,4,44,17,27,3,0,17,16,-1
"700","Calum Chambers",26,"1995","01","20","2018/2019","Defender","Fulham",2587,1458,1129,"England",31,17,14,2,2,0,0,0,0,0,0,5,3,2,49,24,25,9,0,198,399,143
"701","Cameron John",21,"1999","08","24","2018/2019","Defender","Wolverhampton Wanderers",0,0,0,"England",0,0,0,0,0,0,0,0,0,0,0,0,0,0,0,0,0,0,0,-1,-1,-1
"702","Carl Jenkinson",29,"1992","02","08","2018/2019","Defender","Arsenal",166,166,0,"England",3,3,0,0,0,0,0,0,0,0,0,0,0,0,2,2,0,0,0,-1,-1,-1
"703","Carlos Sánchez",35,"1986","02","06","2018/2019","Midfielder","West Ham United",240,120,120,"Colombia",7,4,3,0,0,0,0,0,0,0,0,2,2,0,2,0,2,0,0,-1,-1,-1
"704","Cedric Soares",29,"1991","08","31","2018/2019","Defender","Southampton",1494,651,843,"Portugal",18,8,10,1,1,0,2,0,2,0,0,5,2,3,26,7,19,4,0,204,124,127
"705","Cenk Tosun",29,"1991","06","07","2018/2019","Forward","Everton",1050,536,514,"Turkey",25,13,12,3,2,1,3,1,2,0,0,7,4,3,16,9,7,3,0,74,37,-1
"706","Cesar Azpilicueta",31,"1989","08","28","2018/2019","Defender","Chelsea",3403,1693,1710,"Spain",38,19,19,1,0,1,5,3,2,0,0,16,10,6,38,12,26,4,0,260,116,33
"707","Cesc Fabregas",33,"1987","05","04","2018/2019","Midfielder","Chelsea",175,73,102,"Spain",6,4,2,0,0,0,0,0,0,0,0,3,2,1,2,0,2,1,0,-1,-1,-1
"708","Charlie Austin",31,"1989","07","05","2018/2019","Forward","Southampton",980,454,526,"England",25,13,12,2,1,1,2,1,1,0,1,6,3,3,14,6,8,1,0,105,73,-1
"709","Charlie Daniels",34,"1986","09","07","2018/2019","Defender","AFC Bournemouth",1583,803,780,"England",21,11,10,1,1,0,0,0,0,0,0,6,4,2,32,14,18,4,0,208,254,152
"710","Charlie Taylor",27,"1993","09","18","2018/2019","Defender","Burnley",3240,1636,1604,"England",38,19,19,0,0,0,1,1,0,0,0,8,5,3,53,24,29,2,0,381,239,111
"711","Cheikhou Kouyaté",31,"1989","12","21","2018/2019","Midfielder","Crystal Palace",1897,865,1032,"Senegal",31,14,17,0,0,0,2,1,1,0,0,11,6,5,24,7,17,3,0,323,161,-1
"712","Chris Löwe",31,"1989","04","16","2018/2019","Defender","Huddersfield Town",2056,932,1124,"Germany",29,15,14,0,0,0,2,1,1,0,0,1,1,0,52,19,33,2,0,328,163,169
"713","Chris Mepham",23,"1997","11","05","2018/2019","Defender","AFC Bournemouth",849,436,413,"Wales",13,6,7,0,0,0,1,0,1,0,0,3,1,2,16,7,9,1,0,279,133,142
"714","Chris Smalling",31,"1989","11","22","2018/2019","Defender","Manchester United",2128,1138,990,"England",24,13,11,1,0,1,0,0,0,0,0,4,2,2,34,16,18,1,0,246,294,106
"715","Chris Wood",29,"1991","12","07","2018/2019","Forward","Burnley",2582,1330,1252,"New Zealand",38,19,19,10,4,6,2,0,2,0,0,8,5,3,43,21,22,2,0,50,188,-1
"716","Christian Atsu Twasam",29,"1992","01","10","2018/2019","Midfielder","Newcastle United",1487,710,777,"Ghana",28,13,15,1,1,0,0,0,0,0,0,8,3,5,16,10,6,2,0,206,271,-1
"717","Christian Benteke",30,"1990","12","03","2018/2019","Forward","Crystal Palace",813,526,287,"Belgium",16,10,6,1,0,1,1,0,1,0,0,5,3,2,10,6,4,1,0,149,142,-1
"718","Christian Eriksen",29,"1992","02","14","2018/2019","Midfielder","Tottenham Hotspur",2772,1457,1315,"Denmark",35,18,17,8,6,2,12,8,4,0,0,10,6,4,34,14,20,3,0,76,10,-1
"719","Christian Fuchs",34,"1986","04","07","2018/2019","Defender","Leicester City",206,90,116,"Austria",3,1,2,0,0,0,0,0,0,0,0,0,0,0,4,3,1,0,0,-1,-1,-1
"720","Christian Kabasele",30,"1991","02","24","2018/2019","Defender","Watford",1587,957,630,"Belgium",21,14,7,0,0,0,0,0,0,0,0,4,3,1,25,15,10,4,1,393,402,101
"721","Christopher Schindler",30,"1990","04","29","2018/2019","Defender","Huddersfield Town",3262,1642,1620,"Germany",37,19,18,1,0,1,0,0,0,0,0,5,3,2,69,30,39,6,1,252,345,157
"722","Ciaran Clark",31,"1989","09","26","2018/2019","Defender","Newcastle United",857,416,441,"Republic of Ireland",11,6,5,3,1,2,0,0,0,0,0,2,0,2,14,9,5,1,0,56,315,113
"723","Claudio Andrés Bravo Muñoz",37,"1983","04","13","2018/2019","Goalkeeper","Manchester City",0,0,0,"Chile",0,0,0,0,0,0,0,0,0,0,0,0,0,0,0,0,0,0,0,-1,-1,-1
"724","Collin Quaner",29,"1991","06","18","2018/2019","Forward","Huddersfield Town",37,9,28,"Germany",2,1,1,0,0,0,0,0,0,0,0,0,0,0,2,0,2,0,0,-1,-1,-1
"725","Connor Wickham",28,"1993","03","31","2018/2019","Forward","Crystal Palace",61,49,12,"England",6,3,3,0,0,0,1,0,1,0,0,2,1,1,0,0,0,0,0,-1,-1,-1
"726","Conor Coady",28,"1993","02","25","2018/2019","Midfielder","Wolverhampton Wanderers",3420,1710,1710,"England",38,19,19,0,0,0,0,0,0,0,0,9,7,2,43,20,23,5,0,394,415,-1
"727","Conor Coventry",21,"2000","03","25","2018/2019","Midfielder","West Ham United",0,0,0,"Republic of Ireland",0,0,0,0,0,0,0,0,0,0,0,0,0,0,0,0,0,0,0,-1,-1,-1
"728","Craig Cathcart",32,"1989","02","06","2018/2019","Defender","Watford",3099,1561,1538,"Northern Ireland",36,18,18,3,1,2,0,0,0,0,0,6,3,3,52,28,24,2,0,177,400,119
"729","Curtis Jones",20,"2001","01","30","2018/2019","Midfielder","Liverpool",0,0,0,"England",0,0,0,0,0,0,0,0,0,0,0,0,0,0,0,0,0,0,0,-1,-1,-1
"730","Cyrus Christie",28,"1992","09","30","2018/2019","Defender","Fulham",1943,1053,890,"Republic of Ireland",28,15,13,0,0,0,1,1,0,0,0,5,3,2,40,20,20,7,0,315,205,155
"731","Dale Stephens",31,"1989","06","12","2018/2019","Midfielder","Brighton & Hove Albion",2487,1191,1296,"England",30,14,16,1,0,1,1,0,1,0,0,5,3,2,43,18,25,7,1,247,224,-1
"732","Damián Emiliano Martínez",28,"1992","09","02","2018/2019","Goalkeeper","Arsenal",0,0,0,"Argentina",0,0,0,0,0,0,0,0,0,0,0,0,0,0,0,0,0,0,0,-1,-1,-1
"733","Dan Burn",28,"1992","05","09","2018/2019","Defender","Brighton & Hove Albion",0,0,0,"England",0,0,0,0,0,0,0,0,0,0,0,0,0,0,0,0,0,0,0,-1,-1,-1
"734","Dan Gosling",31,"1990","02","01","2018/2019","Midfielder","AFC Bournemouth",1737,911,826,"England",25,13,12,2,0,2,1,0,1,0,0,7,4,3,31,14,17,8,0,158,206,-1
"735","Daniel Amartey",26,"1994","12","21","2018/2019","Midfielder","Leicester City",640,307,333,"Ghana",9,5,4,0,0,0,0,0,0,0,0,2,1,1,9,4,5,2,0,343,313,-1
"736","Daniel Sturridge",31,"1989","09","01","2018/2019","Forward","Liverpool",496,152,344,"England",18,9,9,2,1,1,1,1,0,0,0,10,7,3,3,0,3,1,0,48,79,-1
"737","Daniel William John Ings",28,"1992","07","23","2018/2019","Forward","Southampton",1668,922,746,"England",24,13,11,7,3,4,3,3,0,3,0,6,2,4,26,13,13,1,0,39,87,-1
"738","Daniel Williams",32,"1989","03","08","2018/2019","Midfielder","Huddersfield Town",93,13,80,"USA",5,1,4,0,0,0,0,0,0,0,0,1,0,1,1,0,1,1,0,-1,-1,-1
"739","Danilo",29,"1991","07","15","2018/2019","Defender","Manchester City",806,450,356,"Brazil",11,5,6,1,0,1,0,0,0,0,0,5,3,2,7,2,5,1,0,151,318,18
"740","Danny Drinkwater",31,"1990","03","05","2018/2019","Midfielder","Chelsea",0,0,0,"England",0,0,0,0,0,0,0,0,0,0,0,0,0,0,0,0,0,0,0,-1,-1,-1
"741","Danny Rose",30,"1990","07","02","2018/2019","Defender","Tottenham Hotspur",1806,969,837,"England",26,13,13,0,0,0,3,1,2,0,0,10,7,3,12,6,6,5,0,287,95,11
"742","Danny Simpson",34,"1987","01","04","2018/2019","Defender","Leicester City",291,26,265,"England",6,2,4,0,0,0,0,0,0,0,0,3,1,2,4,0,4,0,0,269,333,73
"743","Danny Ward",27,"1993","06","22","2018/2019","Goalkeeper","Leicester City",0,0,0,"Wales",0,0,0,0,0,0,0,0,0,0,0,0,0,0,0,0,0,0,0,-1,-1,-1
"744","Danny Ward",30,"1990","12","09","2018/2019","Forward","Cardiff City",440,246,194,"England",14,6,8,1,1,0,0,0,0,0,0,2,0,2,11,8,3,0,0,94,382,-1
"745","Danny Welbeck",30,"1990","11","26","2018/2019","Forward","Arsenal",147,47,100,"England",8,4,4,1,1,0,1,0,1,0,0,2,2,0,2,0,2,0,0,-1,-1,-1
"746","Daryl Janmaat",31,"1989","07","22","2018/2019","Defender","Watford",1521,836,685,"Netherlands",18,10,8,0,0,0,2,2,0,0,0,3,2,1,22,8,14,3,0,395,121,84
"747","David Brooks",23,"1997","07","08","2018/2019","Forward","AFC Bournemouth",2278,1289,989,"England",30,17,13,7,4,3,5,3,2,0,0,9,5,4,39,17,22,3,0,68,66,-1
"748","David Button",32,"1989","02","27","2018/2019","Goalkeeper","Brighton & Hove Albion",360,180,180,"England",4,2,2,0,0,0,0,0,0,0,0,1,1,0,5,1,4,0,0,404,327,79
"749","David de Gea",30,"1990","11","07","2018/2019","Goalkeeper","Manchester United",3420,1710,1710,"Spain",38,19,19,0,0,0,0,0,0,0,0,7,2,5,51,23,28,1,0,310,419,91
"750","David Junior Hoilett",30,"1990","06","05","2018/2019","Forward","Cardiff City",2142,1008,1134,"Canada",32,17,15,3,2,1,1,0,1,0,0,9,5,4,42,20,22,4,0,137,220,-1
"751","David Luiz",33,"1987","04","22","2018/2019","Defender","Chelsea",3239,1709,1530,"Brazil",36,19,17,3,3,0,2,1,1,0,0,16,10,6,35,12,23,3,0,186,198,27
"752","David Silva",35,"1986","01","08","2018/2019","Midfielder","Manchester City",2411,1088,1323,"Spain",33,16,17,6,4,2,8,3,5,0,0,17,8,9,14,7,7,3,0,88,22,-1
"753","Davide Zappacosta",28,"1992","06","11","2018/2019","Defender","Chelsea",125,35,90,"Italy",4,3,1,0,0,0,0,0,0,0,0,3,2,1,0,0,0,0,0,-1,-1,-1
"754","Davinson Sánchez Mina",24,"1996","06","12","2018/2019","Defender","Tottenham Hotspur",1943,873,1070,"Colombia",23,10,13,1,1,0,1,0,1,0,0,6,3,3,21,9,12,2,0,221,208,26
"755","Davy Pröpper",29,"1991","09","02","2018/2019","Midfielder","Brighton & Hove Albion",2551,1371,1180,"Netherlands",30,16,14,1,0,1,1,0,1,0,0,5,4,1,44,19,25,2,0,241,226,-1
"756","DeAndre Yedlin",27,"1993","07","09","2018/2019","Defender","Newcastle United",2475,1313,1162,"USA",29,16,13,1,0,1,2,1,1,0,0,6,4,2,37,19,18,7,1,237,177,93
"757","Declan Rice",22,"1999","01","14","2018/2019","Midfielder","West Ham United",3005,1440,1565,"Republic of Ireland",34,16,18,2,2,0,0,0,0,0,0,6,3,3,42,21,21,4,0,210,362,-1
"758","Dejan Lovren",31,"1989","07","05","2018/2019","Defender","Liverpool",985,540,445,"Croatia",13,7,6,1,1,0,0,0,0,0,0,6,3,3,7,3,4,1,0,173,324,15
"759","Dele Alli",24,"1996","04","11","2018/2019","Midfielder","Tottenham Hotspur",1827,755,1072,"England",25,11,14,5,1,4,3,2,1,0,0,7,3,4,17,4,13,4,0,82,97,-1
"760","Demarai Gray",24,"1996","06","28","2018/2019","Midfielder","Leicester City",1992,1069,923,"England",34,17,17,4,1,3,1,1,0,0,0,8,5,3,26,10,16,2,0,103,212,-1
"761","Demeaco Duhaney",22,"1998","10","13","2018/2019","Defender","Huddersfield Town",46,46,0,"England",1,1,0,0,0,0,0,0,0,0,0,1,1,0,0,0,0,0,0,-1,-1,-1
"762","Denis Odoi",32,"1988","05","27","2018/2019","Defender","Fulham",2593,1153,1440,"Belgium",31,15,16,0,0,0,1,0,1,0,0,5,3,2,59,23,36,4,0,286,244,166
"763","Denis Suárez",27,"1994","01","06","2018/2019","Midfielder","Arsenal",67,29,38,"Spain",4,2,2,0,0,0,0,0,0,0,0,1,1,0,0,0,0,0,0,-1,-1,-1
"764","Diego Rico",28,"1993","02","23","2018/2019","Defender","AFC Bournemouth",607,148,459,"Spain",12,4,8,0,0,0,0,0,0,0,0,0,0,0,18,3,15,1,0,306,261,172
"765","Diogo José Teixeira da Silva",24,"1996","12","04","2018/2019","Midfielder","Wolverhampton Wanderers",2371,1210,1161,"Portugal",33,16,17,9,7,2,5,3,2,0,0,9,7,2,29,11,18,11,0,52,71,-1
"766","Divock Origi",25,"1995","04","18","2018/2019","Forward","Liverpool",366,176,190,"Belgium",12,5,7,3,2,1,1,0,1,0,0,7,4,3,2,0,2,0,0,2,42,-1
"767","Domingos Quina",21,"1999","11","18","2018/2019","Midfielder","Watford",335,217,118,"Portugal",8,5,3,1,1,0,0,0,0,0,0,1,0,1,5,3,2,0,0,72,316,-1
"768","Dominic Calvert-Lewin",24,"1997","03","16","2018/2019","Forward","Everton",1774,1023,751,"England",35,18,17,6,3,3,2,2,0,0,0,13,8,5,24,12,12,3,0,65,145,-1
"769","Dominic Solanke",23,"1997","09","14","2018/2019","Forward","AFC Bournemouth",341,165,176,"England",10,4,6,0,0,0,1,1,0,0,0,2,0,2,4,1,3,0,0,280,38,-1
"770","Dwight McNeil",21,"1999","11","22","2018/2019","Forward","Burnley",1599,941,658,"England",21,12,9,3,3,0,5,3,2,0,0,4,3,1,22,12,10,2,0,112,29,-1
"771","Eden Hazard",30,"1991","01","07","2018/2019","Midfielder","Chelsea",2926,1527,1399,"Belgium",37,19,18,16,11,5,15,10,5,4,0,15,10,5,34,9,25,2,0,18,5,-1
"772","Ederson",27,"1993","08","17","2018/2019","Goalkeeper","Manchester City",3420,1710,1710,"Brazil",38,19,19,0,0,0,1,1,0,0,0,20,9,11,23,12,11,2,0,366,240,13
"773","Edward Nketiah",21,"1999","05","30","2018/2019","Forward","Arsenal",62,4,58,"England",5,1,4,1,0,1,0,0,0,0,0,1,1,0,2,0,2,0,0,-1,-1,-1
"774","Elias Kachunga",28,"1992","04","22","2018/2019","Forward","Huddersfield Town",1181,611,570,"Congo DR",20,9,11,0,0,0,0,0,0,0,0,2,1,1,28,14,14,2,0,303,259,-1
"775","Emerson Hyndman",25,"1996","04","09","2018/2019","Midfielder","AFC Bournemouth",37,0,37,"USA",1,0,1,0,0,0,0,0,0,0,0,0,0,0,2,0,2,0,0,-1,-1,-1
"776","Emerson Palmieri dos Santos",26,"1994","08","03","2018/2019","Defender","Chelsea",660,360,300,"Italy",10,4,6,0,0,0,0,0,0,0,0,3,2,1,10,3,7,0,0,274,296,96
"777","Emile Smith Rowe",20,"2000","07","28","2018/2019","Midfielder","Arsenal",0,0,0,"England",0,0,0,0,0,0,0,0,0,0,0,0,0,0,0,0,0,0,0,-1,-1,-1
"778","Eric Bertrand Bailly",26,"1994","04","12","2018/2019","Defender","Manchester United",637,349,288,"Côte d'Ivoire",12,5,7,0,0,0,0,0,0,0,0,3,0,3,12,6,6,1,1,340,310,141
"779","Eric Dier",27,"1994","01","15","2018/2019","Midfielder","Tottenham Hotspur",1510,674,836,"England",20,9,11,3,2,1,0,0,0,0,0,6,2,4,16,8,8,4,0,107,278,-1
"780","Erik Durm",28,"1992","05","12","2018/2019","Defender","Huddersfield Town",2052,869,1183,"Germany",28,13,15,0,0,0,1,0,1,0,0,3,1,2,43,17,26,0,0,305,232,156
"781","Erik Lamela",29,"1992","03","04","2018/2019","Midfielder","Tottenham Hotspur",971,493,478,"Argentina",19,11,8,4,1,3,2,1,1,0,0,5,3,2,11,5,6,2,0,45,69,-1
"782","Ethan Ampadu",20,"2000","09","14","2018/2019","Midfielder","Chelsea",0,0,0,"Wales",0,0,0,0,0,0,0,0,0,0,0,0,0,0,0,0,0,0,0,-1,-1,-1
"783","Etienne Capoue",32,"1988","07","11","2018/2019","Midfielder","Watford",2947,1518,1429,"France",33,17,16,1,0,1,3,2,1,0,0,7,4,3,47,24,23,15,1,253,153,-1
"784","Fabián Cornelio Balbuena González",29,"1991","08","23","2018/2019","Defender","West Ham United",2014,934,1080,"Paraguay",23,11,12,1,0,1,0,0,0,0,0,5,2,3,27,13,14,2,0,231,356,66
"785","Fabian Delph",31,"1989","11","21","2018/2019","Midfielder","Manchester City",725,266,459,"England",11,5,6,0,0,0,1,1,0,0,0,4,1,3,9,4,5,2,1,295,123,-1
"786","Fabian Schär",29,"1991","12","20","2018/2019","Defender","Newcastle United",2002,1173,829,"Switzerland",24,14,10,4,3,1,1,0,1,0,0,8,5,3,21,14,7,12,0,110,230,23
"787","Fabinho",27,"1993","10","23","2018/2019","Midfielder","Liverpool",2013,1051,962,"Brazil",28,14,14,1,1,0,2,1,1,0,0,15,7,8,13,6,7,6,0,229,166,-1
"788","Fabricio Martín Agosto Ramírez",33,"1987","12","31","2018/2019","Goalkeeper","Fulham",180,90,90,"Spain",2,1,1,0,0,0,0,0,0,0,0,0,0,0,5,2,3,0,0,-1,-1,-1
"789","Faustino Marcos Alberto Rojo",31,"1990","03","20","2018/2019","Defender","Manchester United",211,211,0,"Argentina",5,5,0,0,0,0,0,0,0,0,0,0,0,0,4,4,0,2,0,-1,-1,-1
"790","Federico Fernández",32,"1989","02","21","2018/2019","Defender","Newcastle United",1484,607,877,"Argentina",19,8,11,0,0,0,1,1,0,0,0,4,1,3,22,9,13,2,0,297,194,90
"791","Felipe Anderson Pereira Gomes",27,"1993","04","15","2018/2019","Midfielder","West Ham United",3054,1439,1615,"Brazil",36,17,19,9,4,5,4,2,2,0,0,6,3,3,43,21,22,3,0,70,130,-1
"792","Fernando Llorente Torres",36,"1985","02","26","2018/2019","Forward","Tottenham Hotspur",683,508,175,"Spain",20,11,9,1,1,0,4,4,0,0,0,7,5,2,8,5,3,2,0,133,2,-1
"793","Fernando Luiz Rosa",35,"1985","05","04","2018/2019","Midfielder","Manchester City",2381,1286,1095,"Brazil",29,15,14,1,1,0,3,3,0,0,0,16,7,9,15,8,7,5,0,228,132,-1
"794","Florent Hadergjonaj",26,"1994","07","31","2018/2019","Defender","Huddersfield Town",1840,1011,829,"Switzerland",24,12,12,0,0,0,0,0,0,0,0,4,2,2,34,15,19,1,0,329,376,135
"795","Florian Lejeune",29,"1991","05","20","2018/2019","Defender","Newcastle United",1055,515,540,"France",12,6,6,0,0,0,0,0,0,0,0,3,3,0,12,3,9,0,0,278,301,36
"796","Florin Andone",27,"1993","04","11","2018/2019","Forward","Brighton & Hove Albion",874,416,458,"Romania",23,12,11,3,2,1,0,0,0,0,0,3,3,0,13,5,8,5,0,60,289,-1
"797","Floyd Ayité",32,"1988","12","15","2018/2019","Midfielder","Fulham",465,296,169,"Togo",16,7,9,1,0,1,0,0,0,0,0,3,1,2,13,7,6,0,0,101,268,-1
"798","Fousseni Diabaté",25,"1995","10","18","2018/2019","Midfielder","Leicester City",55,0,55,"Mali",1,0,1,0,0,0,0,0,0,0,0,0,0,0,1,0,1,0,0,-1,-1,-1
"799","Francisco Femenía Far",30,"1991","02","02","2018/2019","Midfielder","Watford",2045,1011,1034,"Spain",29,14,15,1,1,0,1,1,0,0,0,5,3,2,38,21,17,1,0,240,216,-1
"800","Fraser Forster",33,"1988","03","17","2018/2019","Goalkeeper","Southampton",90,0,90,"England",1,0,1,0,0,0,0,0,0,0,0,0,0,0,3,0,3,0,0,-1,-1,-1
"801","Freddie Woodman",24,"1997","03","04","2018/2019","Goalkeeper","Newcastle United",0,0,0,"England",0,0,0,0,0,0,0,0,0,0,0,0,0,0,0,0,0,0,0,-1,-1,-1
"802","Frederico Rodrigues Santos",28,"1993","03","05","2018/2019","Midfielder","Manchester United",1045,577,468,"Brazil",17,9,8,1,1,0,1,0,1,0,0,0,0,0,19,8,11,2,0,178,156,-1
"803","Gabriel Jesus",24,"1997","04","03","2018/2019","Forward","Manchester City",1019,702,317,"Brazil",29,14,15,7,5,2,3,1,2,1,0,16,7,9,11,7,4,1,0,6,33,-1
"804","Gaëtan Bong Songo",32,"1988","04","25","2018/2019","Defender","Brighton & Hove Albion",1805,720,1085,"Cameroon",22,8,14,0,0,0,0,0,0,0,0,5,3,2,32,9,23,0,0,401,336,132
"805","Gary Cahill",35,"1985","12","19","2018/2019","Defender","Chelsea",22,1,21,"England",2,1,1,0,0,0,0,0,0,0,0,2,1,1,0,0,0,0,0,-1,-1,-1
"806","Gary Madine",30,"1990","08","24","2018/2019","Forward","Cardiff City",32,17,15,"England",5,3,2,0,0,0,0,0,0,0,0,0,0,0,2,0,2,0,0,-1,-1,-1
"807","George Marsh",22,"1998","11","05","2018/2019","Midfielder","Tottenham Hotspur",0,0,0,"England",0,0,0,0,0,0,0,0,0,0,0,0,0,0,0,0,0,0,0,-1,-1,-1
"808","Georges-Kevin N'Koudou Mbida",26,"1995","02","13","2018/2019","Forward","Tottenham Hotspur",4,0,4,"France",1,0,1,0,0,0,1,0,1,0,0,0,0,0,0,0,0,0,0,-1,-1,-1
"809","Georginio Wijnaldum",30,"1990","11","11","2018/2019","Midfielder","Liverpool",2735,1413,1322,"Netherlands",35,18,17,3,1,2,0,0,0,0,0,21,12,9,15,6,9,3,0,164,416,-1
"810","Gerard Deulofeu",27,"1994","03","13","2018/2019","Forward","Watford",2082,949,1133,"Spain",30,14,16,10,3,7,5,3,2,0,0,6,3,3,28,11,17,3,0,29,59,-1
"811","Glenn Murray",37,"1983","09","25","2018/2019","Forward","Brighton & Hove Albion",2513,1383,1130,"England",38,19,19,13,8,5,1,1,0,4,0,7,5,2,44,22,22,5,0,24,227,-1
"812","Gonzalo Higuain",33,"1987","12","10","2018/2019","Forward","Chelsea",1092,496,596,"Argentina",14,6,8,5,4,1,0,0,0,0,0,5,4,1,15,3,12,0,0,33,306,-1
"813","Grady Diangana",22,"1998","04","19","2018/2019","Midfielder","West Ham United",604,326,278,"England",17,9,8,0,0,0,1,1,0,0,0,2,1,1,11,8,3,0,0,298,89,-1
"814","Granit Xhaka",28,"1992","09","27","2018/2019","Midfielder","Arsenal",2502,1317,1185,"Switzerland",29,15,14,4,2,2,2,0,2,0,0,7,6,1,35,11,24,10,0,127,183,-1
"815","Greg Cunningham",30,"1991","01","31","2018/2019","Defender","Cardiff City",630,450,180,"Republic of Ireland",7,5,2,0,0,0,0,0,0,0,0,1,0,1,16,15,1,3,0,313,381,170
"816","Gylfi Sigurdsson",31,"1989","09","08","2018/2019","Midfielder","Everton",3134,1602,1532,"Iceland",38,19,19,13,7,6,6,2,4,2,3,14,9,5,40,19,21,3,0,43,86,-1
"817","Hamza Choudhury",23,"1997","10","01","2018/2019","Midfielder","Leicester City",596,308,288,"England",9,4,5,0,0,0,0,0,0,0,0,4,2,2,4,3,1,0,0,275,297,-1
"818","Harry Arter",31,"1989","12","28","2018/2019","Midfielder","Cardiff City",2008,1186,822,"Republic of Ireland",25,14,11,0,0,0,1,1,0,0,0,7,4,3,37,25,12,10,0,304,221,-1
"819","Harry Kane",27,"1993","07","28","2018/2019","Forward","Tottenham Hotspur",2427,1066,1361,"England",28,12,16,17,6,11,4,2,2,4,0,10,4,6,28,10,18,5,0,5,94,-1
"820","Harry Maguire",28,"1993","03","05","2018/2019","Defender","Leicester City",2599,1350,1249,"England",31,15,16,3,0,3,0,0,0,0,0,7,3,4,36,16,20,7,1,165,299,78
"821","Harry Winks",25,"1996","02","02","2018/2019","Midfielder","Tottenham Hotspur",1591,832,759,"England",26,13,13,1,0,1,0,0,0,0,0,10,4,6,16,8,8,4,0,207,335,-1
"822","Harvey Elliot",0,"1970","01","01","2018/2019","Forward","Fulham",18,16,2,"England",2,1,1,0,0,0,0,0,0,0,0,0,0,0,0,0,0,0,0,-1,-1,-1
"823","Harvey Lewis Barnes",23,"1997","12","09","2018/2019","Midfielder","Leicester City",1007,601,406,"England",16,9,7,1,0,1,2,2,0,0,0,3,3,0,16,7,9,0,0,175,78,-1
"824","Håvard Nordtveit",30,"1990","06","21","2018/2019","Midfielder","Fulham",361,90,271,"Norway",5,1,4,0,0,0,1,0,1,0,0,1,0,1,9,2,7,0,0,419,41,-1
"825","Hector Bellerin",26,"1995","03","19","2018/2019","Defender","Arsenal",1535,882,653,"Spain",19,10,9,0,0,0,5,4,1,0,0,4,4,0,20,8,12,3,0,385,26,61
"826","Hélder Wander Sousa Azevedo Costa",27,"1994","01","12","2018/2019","Midfielder","Wolverhampton Wanderers",1345,657,688,"Portugal",25,11,14,1,0,1,2,1,1,0,0,5,3,2,18,10,8,3,0,200,113,-1
"827","Henrikh Mkhitaryan",32,"1989","01","21","2018/2019","Midfielder","Arsenal",1643,650,993,"Armenia",25,11,14,6,3,3,4,3,1,0,0,4,3,1,25,9,16,1,0,53,56,-1
"828","Heung-Min Son",28,"1992","07","08","2018/2019","Forward","Tottenham Hotspur",2048,1161,887,"South Korea",31,16,15,12,8,4,6,2,4,0,0,11,7,4,20,8,12,3,1,14,34,-1
"829","Heurelho da Silva Gomes",40,"1981","02","15","2018/2019","Goalkeeper","Watford",0,0,0,"Brazil",0,0,0,0,0,0,0,0,0,0,0,0,0,0,0,0,0,0,0,-1,-1,-1
"830","Hugo Lloris",34,"1986","12","26","2018/2019","Goalkeeper","Tottenham Hotspur",2970,1620,1350,"France",33,18,15,0,0,0,0,0,0,0,0,12,7,5,30,13,17,0,0,339,284,21
"831","Ibrahima Cissé",27,"1994","02","28","2018/2019","Midfielder","Fulham",87,9,78,"Belgium",3,1,2,0,0,0,0,0,0,0,0,0,0,0,3,0,3,0,0,-1,-1,-1
"832","Idrissa Gana Gueye",31,"1989","09","26","2018/2019","Midfielder","Everton",2825,1407,1418,"Senegal",33,16,17,0,0,0,2,1,1,0,0,13,9,4,29,10,19,6,0,413,193,-1
"833","İlkay Gündoğan",30,"1990","10","24","2018/2019","Midfielder","Manchester City",2135,985,1150,"Germany",31,15,16,6,4,2,3,0,3,0,0,15,6,9,15,8,7,3,0,78,120,-1
"834","Isaac Ajayi Success",25,"1996","01","07","2018/2019","Forward","Watford",1037,461,576,"Nigeria",30,15,15,1,1,0,1,0,1,0,0,5,3,2,20,8,12,4,0,181,154,-1
"835","Isaac Hayden",26,"1995","03","22","2018/2019","Midfielder","Newcastle United",1886,904,982,"England",25,11,14,1,0,1,4,4,0,0,0,7,3,4,25,12,13,4,1,219,67,-1
"836","Isaac Mbenza",25,"1996","03","08","2018/2019","Forward","Huddersfield Town",981,589,392,"Belgium",22,13,9,1,1,0,1,1,0,0,0,4,2,2,25,15,10,1,0,172,165,-1
"837","Issa Diop",24,"1997","01","09","2018/2019","Defender","West Ham United",2970,1530,1440,"France",33,17,16,1,1,0,0,0,0,0,0,7,4,3,38,20,18,4,0,248,364,55
"838","Ivan Ricardo Neves Abreu Cavaleiro",27,"1993","10","18","2018/2019","Forward","Wolverhampton Wanderers",683,331,352,"Portugal",23,13,10,3,2,1,1,0,1,0,0,5,4,1,10,7,3,1,0,34,119,-1
"839","Jack Cork",31,"1989","06","25","2018/2019","Midfielder","Burnley",3313,1693,1620,"England",37,19,18,1,1,0,2,1,1,0,0,8,5,3,54,27,27,6,0,249,204,-1
"840","Jack Simpson",24,"1996","12","18","2018/2019","Defender","AFC Bournemouth",403,240,163,"England",6,3,3,0,0,0,0,0,0,0,0,2,1,1,9,2,7,0,0,272,314,163
"841","Jack Stephens",27,"1994","01","27","2018/2019","Defender","Southampton",1697,816,881,"England",24,10,14,1,1,0,0,0,0,0,0,5,2,3,30,11,19,4,0,223,369,130
"842","Jack Wilshere",29,"1992","01","01","2018/2019","Midfielder","West Ham United",389,181,208,"England",8,4,4,0,0,0,1,0,1,0,0,2,1,1,8,2,6,2,0,369,48,-1
"843","Jacob Murphy",26,"1995","02","24","2018/2019","Midfielder","Newcastle United",300,167,133,"England",9,3,6,0,0,0,1,0,1,0,0,1,0,1,7,3,4,0,0,301,21,-1
"844","Jaïro Riedewald",24,"1996","09","09","2018/2019","Defender","Crystal Palace",0,0,0,"Netherlands",0,0,0,0,0,0,0,0,0,0,0,0,0,0,0,0,0,0,0,-1,-1,-1
"845","Jamal Lascelles",27,"1993","11","11","2018/2019","Defender","Newcastle United",2748,1308,1440,"England",32,16,16,0,0,0,1,1,0,0,0,11,5,6,33,16,17,4,0,346,245,41
"846","James Garner",20,"2001","03","13","2018/2019","Defender","Manchester United",0,0,0,"England",1,0,1,0,0,0,0,0,0,0,0,0,0,0,0,0,0,0,0,-1,-1,-1
"847","James Maddison",24,"1996","11","23","2018/2019","Midfielder","Leicester City",2850,1535,1315,"England",36,18,18,7,3,4,7,4,3,1,1,8,5,3,39,18,21,5,1,83,60,-1
"848","James McArthur",33,"1987","10","07","2018/2019","Midfielder","Crystal Palace",3071,1506,1565,"Scotland",38,19,19,3,1,2,6,1,5,0,0,12,7,5,44,19,25,7,0,179,74,-1
"849","James McCarthy",30,"1990","11","12","2018/2019","Midfielder","Everton",14,14,0,"Republic of Ireland",1,1,0,0,0,0,0,0,0,0,0,1,1,0,0,0,0,0,0,-1,-1,-1
"850","James Milner",35,"1986","01","04","2018/2019","Midfielder","Liverpool",1785,646,1139,"England",31,12,19,5,0,5,4,2,2,3,0,18,9,9,11,4,7,7,1,81,65,-1
"851","James Tarkowski",28,"1992","11","19","2018/2019","Defender","Burnley",3087,1620,1467,"England",35,18,17,3,2,1,1,1,0,0,0,7,5,2,52,25,27,8,0,170,238,121
"852","James Tomkins",32,"1989","03","29","2018/2019","Defender","Crystal Palace",2563,1140,1423,"England",29,13,16,1,0,1,1,0,1,0,0,10,5,5,34,12,22,6,0,235,215,63
"853","James Ward-Prowse",26,"1994","11","01","2018/2019","Midfielder","Southampton",1942,942,1000,"England",26,13,13,7,5,2,0,0,0,1,0,4,2,2,36,15,21,4,0,58,347,-1
"854","Jamie Sterry",25,"1995","11","21","2018/2019","Defender","Newcastle United",0,0,0,"England",0,0,0,0,0,0,0,0,0,0,0,0,0,0,0,0,0,0,0,-1,-1,-1
"855","Jamie Vardy",34,"1987","01","11","2018/2019","Forward","Leicester City",2735,1418,1317,"England",34,17,17,18,8,10,4,3,1,4,1,10,6,4,33,13,20,4,1,9,118,-1
"856","Jan Bednarek",24,"1996","04","12","2018/2019","Defender","Southampton",2151,1126,1025,"Poland",25,13,12,0,0,0,1,0,1,0,0,3,1,2,33,19,14,7,0,377,225,98
"857","Jan Vertonghen",33,"1987","04","24","2018/2019","Defender","Tottenham Hotspur",1915,884,1031,"Belgium",22,10,12,1,0,1,0,0,0,0,0,7,4,3,21,7,14,5,1,225,282,31
"858","Jannik Vestergaard",28,"1992","08","03","2018/2019","Defender","Southampton",2030,1130,900,"Denmark",23,13,10,0,0,0,0,0,0,0,0,4,2,2,27,14,13,2,0,373,367,65
"859","Jason Puncheon",34,"1986","06","26","2018/2019","Midfielder","Huddersfield Town",391,248,143,"England",11,6,5,0,0,0,0,0,0,0,0,3,2,1,8,6,2,1,0,302,258,-1
"860","Jason Steele",30,"1990","08","18","2018/2019","Goalkeeper","Brighton & Hove Albion",0,0,0,"England",0,0,0,0,0,0,0,0,0,0,0,0,0,0,0,0,0,0,0,-1,-1,-1
"861","Javier Hernandez",32,"1988","06","01","2018/2019","Forward","West Ham United",1335,694,641,"Mexico",25,13,12,7,5,2,1,0,1,0,0,3,1,2,16,8,8,2,0,23,186,-1
"862","Javier Manquillo Gaitán",26,"1994","05","05","2018/2019","Defender","Newcastle United",1097,503,594,"Spain",18,9,9,0,0,0,3,2,1,0,0,6,3,3,12,6,6,2,0,350,40,30
"863","Jayson Molumby",21,"1999","08","06","2018/2019","Midfielder","Brighton & Hove Albion",0,0,0,"Republic of Ireland",0,0,0,0,0,0,0,0,0,0,0,0,0,0,0,0,0,0,0,-1,-1,-1
"864","Jazz Richards",29,"1991","04","12","2018/2019","Defender","Cardiff City",128,52,76,"Wales",4,2,2,0,0,0,0,0,0,0,0,1,0,1,4,2,2,0,0,-1,-1,-1
"865","Jean Michaël Seri",29,"1991","07","19","2018/2019","Midfielder","Fulham",2252,1112,1140,"Côte d'Ivoire",32,15,17,1,1,0,2,0,2,0,0,4,2,2,53,23,30,6,0,236,171,-1
"866","Jeff Hendrick",29,"1992","01","31","2018/2019","Midfielder","Burnley",2069,898,1171,"Republic of Ireland",32,15,17,3,1,2,0,0,0,0,0,6,3,3,41,18,23,4,0,131,349,-1
"867","Jefferson Lerma",26,"1994","10","25","2018/2019","Midfielder","AFC Bournemouth",2511,1319,1192,"Colombia",30,15,15,2,0,2,0,0,0,0,0,8,4,4,45,18,27,12,0,202,288,-1
"868","Jeffrey Schlupp",28,"1992","12","23","2018/2019","Defender","Crystal Palace",1665,849,816,"Ghana",30,14,16,4,1,3,1,1,0,0,0,8,4,4,24,11,13,1,0,89,209,86
"869","Jermain Defoe",38,"1982","10","07","2018/2019","Forward","AFC Bournemouth",21,0,21,"England",4,1,3,0,0,0,0,0,0,0,0,2,1,1,2,0,2,0,0,-1,-1,-1
"870","Jesse Lingard",28,"1992","12","15","2018/2019","Midfielder","Manchester United",1668,963,705,"England",27,15,12,4,1,3,2,1,1,1,0,6,2,4,25,16,9,3,0,87,135,-1
"871","João Moutinho",34,"1986","09","08","2018/2019","Midfielder","Wolverhampton Wanderers",3040,1532,1508,"Portugal",38,19,19,1,0,1,8,5,3,0,0,9,7,2,37,17,20,4,0,258,44,-1
"872","Joe Bennett",31,"1990","03","28","2018/2019","Defender","Cardiff City",2641,1142,1499,"England",30,13,17,0,0,0,1,1,0,0,0,9,5,4,43,18,25,5,0,324,241,112
"873","Joe Bryan",27,"1993","09","17","2018/2019","Defender","Fulham",2350,1214,1136,"England",28,15,13,0,0,0,1,1,0,0,0,5,3,2,51,21,30,5,0,316,218,158
"874","Joe Daniel Tupper",23,"1997","11","15","2018/2019","Goalkeeper","Crystal Palace",0,0,0,"England",0,0,0,0,0,0,0,0,0,0,0,0,0,0,0,0,0,0,0,-1,-1,-1
"875","Joe Gomez",23,"1997","05","23","2018/2019","Defender","Liverpool",1060,493,567,"England",16,8,8,0,0,0,0,0,0,0,0,11,8,3,3,0,3,2,0,407,398,1
"876","Joe Hart",33,"1987","04","19","2018/2019","Goalkeeper","Burnley",1710,810,900,"England",19,9,10,0,0,0,0,0,0,0,0,4,2,2,34,17,17,0,0,367,341,149
"877","Joe Powell",22,"1998","10","30","2018/2019","Forward","West Ham United",0,0,0,"England",0,0,0,0,0,0,0,0,0,0,0,0,0,0,0,0,0,0,0,-1,-1,-1
"878","Joe Ralls",27,"1993","10","13","2018/2019","Midfielder","Cardiff City",1959,847,1112,"England",28,15,13,0,0,0,0,0,0,0,1,8,5,3,35,17,18,5,1,336,383,-1
"879","Joel Coleman",25,"1995","09","26","2018/2019","Goalkeeper","Huddersfield Town",90,0,90,"England",1,0,1,0,0,0,0,0,0,0,0,0,0,0,1,0,1,0,0,-1,-1,-1
"880","Joel Matip",29,"1991","08","08","2018/2019","Defender","Liverpool",1532,811,721,"Cameroon",22,10,12,1,1,0,0,0,0,0,0,11,6,5,9,5,4,3,0,215,286,8
"881","Joel Ward",31,"1989","10","29","2018/2019","Defender","Crystal Palace",551,191,360,"England",7,3,4,1,1,0,0,0,0,0,0,0,0,0,12,6,6,1,0,114,358,159
"882","Johann Berg Guðmunds­son",30,"1990","10","27","2018/2019","Midfielder","Burnley",1748,847,901,"Iceland",29,15,14,3,0,3,6,5,1,0,0,6,4,2,31,13,18,2,0,122,18,-1
"883","John Ruddy",34,"1986","10","24","2018/2019","Goalkeeper","Wolverhampton Wanderers",90,90,0,"England",1,1,0,0,0,0,0,0,0,0,0,1,1,0,0,0,0,0,0,-1,-1,-1
"884","John Stones",26,"1994","05","28","2018/2019","Defender","Manchester City",1762,968,794,"England",24,12,12,0,0,0,0,0,0,0,0,13,6,7,15,8,7,1,0,309,418,17
"885","Jon Gorenc Stankovič",25,"1996","01","14","2018/2019","Defender","Huddersfield Town",718,218,500,"Slovenia",11,3,8,1,0,1,0,0,0,0,0,2,1,1,19,3,16,2,0,139,291,171
"886","Jonas Lössl",32,"1989","02","01","2018/2019","Goalkeeper","Huddersfield Town",2777,1427,1350,"Denmark",31,16,15,0,0,0,1,1,0,0,0,5,3,2,52,22,30,1,0,333,247,139
"887","Jonathan Hogg",32,"1988","12","06","2018/2019","Midfielder","Huddersfield Town",2377,1294,1083,"England",29,16,13,0,0,0,1,1,0,0,0,5,3,2,42,23,19,9,1,330,231,-1
"888","Jonathan Walters",37,"1983","09","20","2018/2019","Forward","Burnley",0,0,0,"Republic of Ireland",0,0,0,0,0,0,0,0,0,0,0,0,0,0,0,0,0,0,0,-1,-1,-1
"889","Jonjo Shelvey",29,"1992","02","27","2018/2019","Midfielder","Newcastle United",944,403,541,"England",16,8,8,1,0,1,1,0,1,0,0,5,1,4,11,8,3,1,0,167,149,-1
"890","Jonjoe Kenny",24,"1997","03","15","2018/2019","Defender","Everton",790,413,377,"England",10,5,5,0,0,0,1,1,0,0,0,2,1,1,14,7,7,1,0,289,143,129
"891","Jonny",27,"1994","03","03","2018/2019","Defender","Wolverhampton Wanderers",2780,1269,1511,"Spain",33,16,17,1,1,0,1,1,0,0,0,8,6,2,36,16,20,6,0,257,237,59
"892","Jonny Evans",33,"1988","01","03","2018/2019","Defender","Leicester City",1995,1074,921,"Northern Ireland",24,12,12,1,1,0,0,0,0,0,0,8,6,2,22,9,13,2,0,224,319,32
"893","Jordan Ayew",29,"1991","09","11","2018/2019","Forward","Crystal Palace",1186,616,570,"Ghana",20,8,12,1,0,1,2,0,2,0,0,6,3,3,13,7,6,3,0,187,96,-1
"894","Jordan Henderson",30,"1990","06","17","2018/2019","Midfielder","Liverpool",1983,925,1058,"England",32,16,16,1,0,1,3,2,1,0,0,19,10,9,11,4,7,3,1,217,102,-1
"895","Jordan Pickford",27,"1994","03","07","2018/2019","Goalkeeper","Everton",3420,1710,1710,"England",38,19,19,0,0,0,0,0,0,0,0,14,9,5,44,20,24,1,0,409,260,57
"896","Jordon Ibe",25,"1995","12","08","2018/2019","Midfielder","AFC Bournemouth",795,334,461,"England",19,10,9,1,0,1,1,1,0,0,0,4,4,0,21,3,18,1,0,154,134,-1
"897","Jorginho",29,"1991","12","20","2018/2019","Midfielder","Chelsea",3165,1621,1544,"Italy",37,19,18,2,0,2,0,0,0,1,0,16,10,6,36,12,24,8,0,213,375,-1
"898","José Diogo Dalot Teixeira",22,"1999","03","18","2018/2019","Defender","Manchester United",1015,525,490,"Portugal",16,7,9,0,0,0,2,2,0,0,0,2,0,2,18,8,10,3,0,283,77,131
"899","José Holebas",36,"1984","06","27","2018/2019","Defender","Watford",2394,1224,1170,"Greece",28,15,13,3,2,1,6,5,1,0,0,5,3,2,38,20,18,13,1,153,49,105
"900","Jose Izquierdo",28,"1992","07","07","2018/2019","Forward","Brighton & Hove Albion",794,365,429,"Colombia",15,8,7,0,0,0,1,0,1,0,0,5,3,2,8,4,4,1,0,266,136,-1
"901","José Luis Sanmartín Mato",31,"1990","03","27","2018/2019","Forward","Newcastle United",586,308,278,"Spain",16,9,7,2,2,0,0,0,0,0,0,4,2,2,12,8,4,1,0,61,265,-1
"902","Joseph Willock",21,"1999","08","20","2018/2019","Midfielder","Arsenal",64,0,64,"England",2,0,2,0,0,0,0,0,0,0,0,0,0,0,0,0,0,0,0,-1,-1,-1
"903","Josh Benson",21,"1999","12","05","2018/2019","Midfielder","Burnley",0,0,0,"England",0,0,0,0,0,0,0,0,0,0,0,0,0,0,0,0,0,0,0,-1,-1,-1
"904","Josh Knight",23,"1997","09","07","2018/2019","Defender","Leicester City",0,0,0,"England",0,0,0,0,0,0,0,0,0,0,0,0,0,0,0,0,0,0,0,-1,-1,-1
"905","Josh Murphy",26,"1995","02","24","2018/2019","Forward","Cardiff City",1825,1123,702,"England",29,17,12,3,2,1,2,1,1,0,0,7,4,3,27,20,7,2,0,119,147,-1
"906","Joshua King",29,"1992","01","15","2018/2019","Forward","AFC Bournemouth",2974,1563,1411,"Norway",35,18,17,12,9,3,3,3,0,5,1,9,6,3,54,20,34,3,0,49,157,-1
"907","Joshua Sims",24,"1997","03","28","2018/2019","Midfielder","Southampton",209,139,70,"England",7,4,3,0,0,0,1,1,0,0,0,1,0,1,5,3,2,0,0,-1,-1,-1
"908","Juan Marcos Foyth",23,"1998","01","12","2018/2019","Defender","Tottenham Hotspur",930,450,480,"Argentina",12,6,6,1,0,1,0,0,0,0,0,4,3,1,10,2,8,4,1,157,334,28
"909","Juan Mata",32,"1988","04","28","2018/2019","Midfielder","Manchester United",1294,833,461,"Spain",22,13,9,3,3,0,2,2,0,0,0,4,2,2,14,6,8,3,0,92,103,-1
"910","Julián Speroni",41,"1979","05","18","2018/2019","Goalkeeper","Crystal Palace",90,0,90,"Argentina",1,0,1,0,0,0,0,0,0,0,0,0,0,0,3,0,3,0,0,-1,-1,-1
"911","Juninho Bacuna",23,"1997","08","07","2018/2019","Midfielder","Huddersfield Town",1414,722,692,"Netherlands",21,11,10,1,0,1,0,0,0,0,0,2,2,0,36,15,21,4,0,205,325,-1
"912","Junior Stanislas",31,"1989","11","26","2018/2019","Midfielder","AFC Bournemouth",1027,559,468,"England",23,12,11,2,1,1,3,3,0,1,0,7,4,3,24,8,16,1,0,104,35,-1
"913","Jürgen Locadia",27,"1993","11","07","2018/2019","Forward","Brighton & Hove Albion",1227,590,637,"Netherlands",26,14,12,2,2,0,0,0,0,0,0,4,3,1,19,9,10,1,0,120,281,-1
"914","Kadeem Harris",27,"1993","06","08","2018/2019","Midfielder","Cardiff City",366,133,233,"England",13,5,8,1,1,0,0,0,0,0,0,4,1,3,5,1,4,1,0,79,262,-1
"915","Karl Darlow",30,"1990","10","08","2018/2019","Goalkeeper","Newcastle United",0,0,0,"England",0,0,0,0,0,0,0,0,0,0,0,0,0,0,0,0,0,0,0,-1,-1,-1
"916","Karlan Ahearne-Grant",23,"1997","12","19","2018/2019","Forward","Huddersfield Town",874,331,543,"England",13,6,7,4,2,2,0,0,0,0,0,1,1,0,22,7,15,0,0,31,308,-1
"917","Kasper Schmeichel",34,"1986","11","05","2018/2019","Goalkeeper","Leicester City",3420,1710,1710,"Denmark",38,19,19,0,0,0,0,0,0,0,0,10,6,4,43,18,25,3,0,342,302,50
"918","Kayne Ramsey",20,"2000","10","10","2018/2019","Midfielder","Southampton",90,90,0,"England",1,1,0,0,0,0,0,0,0,0,0,0,0,0,3,3,0,0,0,-1,-1,-1
"919","Kazaiah Sterling",22,"1998","11","09","2018/2019","Forward","Tottenham Hotspur",0,0,0,"England",0,0,0,0,0,0,0,0,0,0,0,0,0,0,0,0,0,0,0,-1,-1,-1
"920","Kelechi Iheanacho",24,"1996","10","03","2018/2019","Forward","Leicester City",926,408,518,"Nigeria",30,14,16,1,1,0,3,2,1,0,0,6,4,2,11,5,6,2,0,169,24,-1
"921","Kelland Watts",21,"1999","11","03","2018/2019","Midfielder","Newcastle United",0,0,0,"England",0,0,0,0,0,0,0,0,0,0,0,0,0,0,0,0,0,0,0,-1,-1,-1
"922","Ken Sema",27,"1993","09","30","2018/2019","Midfielder","Watford",755,301,454,"Sweden",17,8,9,1,0,1,2,1,1,0,0,6,4,2,8,3,5,1,0,143,47,-1
"923","Kenneth Dahrup Zohorè",27,"1994","01","31","2018/2019","Forward","Cardiff City",746,388,358,"Denmark",19,11,8,1,0,1,1,0,1,0,0,5,2,3,15,9,6,1,0,142,128,-1
"924","Kepa Arrizabalaga",26,"1994","10","03","2018/2019","Goalkeeper","Chelsea",3240,1620,1620,"Spain",36,18,18,0,0,0,0,0,0,0,0,14,9,5,38,12,26,2,0,364,363,39
"925","Kevin De Bruyne",29,"1991","06","28","2018/2019","Midfielder","Manchester City",974,477,497,"Belgium",19,9,10,2,2,0,2,0,2,0,0,12,6,6,3,1,2,2,0,109,75,-1
"926","Kevin Long",30,"1990","08","18","2018/2019","Defender","Burnley",513,90,423,"Republic of Ireland",6,1,5,0,0,0,1,0,1,0,0,1,0,1,7,2,5,0,0,293,72,70
"927","Kevin McDonald",32,"1988","11","04","2018/2019","Midfielder","Fulham",842,399,443,"Scotland",15,8,7,0,0,0,0,0,0,0,0,0,0,0,25,12,13,6,1,317,410,-1
"928","Kieran Dowell",23,"1997","10","10","2018/2019","Midfielder","Everton",0,0,0,"England",0,0,0,0,0,0,0,0,0,0,0,0,0,0,0,0,0,0,0,-1,-1,-1
"929","Kieran Trippier",30,"1990","09","19","2018/2019","Defender","Tottenham Hotspur",2278,1188,1090,"England",27,14,13,1,1,0,3,0,3,0,0,10,5,5,20,10,10,2,0,230,122,19
"930","Konstantinos Mavropanos",23,"1997","12","11","2018/2019","Defender","Arsenal",150,46,104,"Greece",4,1,3,0,0,0,0,0,0,0,0,1,0,1,1,1,0,1,0,-1,-1,-1
"931","Kortney Hause",25,"1995","07","16","2018/2019","Defender","Wolverhampton Wanderers",0,0,0,"England",0,0,0,0,0,0,0,0,0,0,0,0,0,0,0,0,0,0,0,-1,-1,-1
"932","Kurt Zouma",26,"1994","10","27","2018/2019","Defender","Everton",2610,1350,1260,"France",32,16,16,2,1,1,2,0,2,0,0,11,8,3,37,17,20,5,1,192,185,83
"933","Kyle Taylor",21,"1999","08","28","2018/2019","Midfielder","AFC Bournemouth",0,0,0,"England",0,0,0,0,0,0,0,0,0,0,0,0,0,0,0,0,0,0,0,-1,-1,-1
"934","Kyle Walker",30,"1990","05","28","2018/2019","Defender","Manchester City",2777,1245,1532,"England",33,15,18,1,1,0,1,0,1,0,0,18,7,11,17,9,8,3,0,250,248,10
"935","Kyle Walker-Peters",23,"1997","04","13","2018/2019","Defender","Tottenham Hotspur",374,272,102,"England",6,4,2,0,0,0,3,3,0,0,0,3,2,1,4,2,2,1,0,357,1,25
"936","Laurent Depoitre",32,"1988","12","07","2018/2019","Forward","Huddersfield Town",1059,446,613,"Belgium",23,12,11,0,0,0,1,0,1,0,0,3,2,1,22,6,16,1,0,331,169,-1
"937","Laurent Koscielny",35,"1985","09","10","2018/2019","Defender","Arsenal",1328,484,844,"France",17,6,11,3,2,1,0,0,0,0,0,4,3,1,21,5,16,1,0,93,295,103
"938","Lazar Marković",27,"1994","03","02","2018/2019","Midfielder","Fulham",44,0,44,"Serbia",1,0,1,0,0,0,0,0,0,0,0,0,0,0,0,0,0,0,0,-1,-1,-1
"939","Leander Dendoncker",25,"1995","04","15","2018/2019","Midfielder","Wolverhampton Wanderers",1469,635,834,"Belgium",19,9,10,2,1,1,0,0,0,0,0,4,4,0,19,6,13,1,0,146,331,-1
"940","Leandro Bacuna",29,"1991","08","21","2018/2019","Midfielder","Cardiff City",554,302,252,"Curaçao",11,6,5,0,0,0,0,0,0,0,0,4,2,2,11,10,1,2,0,281,309,-1
"941","Lee Grant",38,"1983","01","27","2018/2019","Goalkeeper","Manchester United",0,0,0,"England",0,0,0,0,0,0,0,0,0,0,0,0,0,0,0,0,0,0,0,-1,-1,-1
"942","Lee Peltier",34,"1986","12","11","2018/2019","Defender","Cardiff City",1542,521,1021,"England",20,7,13,0,0,0,0,0,0,0,0,6,2,4,21,9,12,4,0,352,391,72
"943","Leighton Baines",36,"1984","12","11","2018/2019","Defender","Everton",376,141,235,"England",6,3,3,0,0,0,0,0,0,0,0,1,0,1,6,2,4,0,0,410,287,109
"944","Leon Balogun",32,"1988","06","28","2018/2019","Defender","Brighton & Hove Albion",591,309,282,"Nigeria",8,4,4,1,1,0,0,0,0,0,0,0,0,0,9,5,4,2,0,121,292,97
"945","Leonardo Bonatini Lohner Maia",27,"1994","03","28","2018/2019","Forward","Wolverhampton Wanderers",128,61,67,"Brazil",7,4,3,0,0,0,1,0,1,0,0,3,2,1,0,0,0,0,0,-1,-1,-1
"946","Leroy Sané",25,"1996","01","11","2018/2019","Midfielder","Manchester City",1867,1024,843,"Germany",31,16,15,10,5,5,10,6,4,0,0,16,8,8,14,8,6,1,0,19,4,-1
"947","Lewis Cass",21,"2000","02","27","2018/2019","Defender","Newcastle United",0,0,0,"England",0,0,0,0,0,0,0,0,0,0,0,0,0,0,0,0,0,0,0,-1,-1,-1
"948","Lewis Cook",24,"1997","02","03","2018/2019","Midfielder","AFC Bournemouth",721,381,340,"England",13,7,6,0,0,0,0,0,0,0,0,3,1,2,10,5,5,2,0,362,393,-1
"949","Lewis Dunk",29,"1991","11","21","2018/2019","Defender","Brighton & Hove Albion",3153,1550,1603,"England",36,18,18,2,0,2,1,0,1,0,0,7,5,2,53,24,29,7,1,203,252,120
"950","Loïc Damour",30,"1991","01","08","2018/2019","Midfielder","Cardiff City",21,4,17,"France",2,1,1,0,0,0,0,0,0,0,0,0,0,0,2,0,2,0,0,-1,-1,-1
"951","Loris Karius",27,"1993","06","22","2018/2019","Goalkeeper","Liverpool",0,0,0,"Germany",0,0,0,0,0,0,0,0,0,0,0,0,0,0,0,0,0,0,0,-1,-1,-1
"952","Luca de la Torre",22,"1998","05","23","2018/2019","Midfielder","Fulham",0,0,0,"USA",0,0,0,0,0,0,0,0,0,0,0,0,0,0,0,0,0,0,0,-1,-1,-1
"953","Lucas Digne",27,"1993","07","20","2018/2019","Defender","Everton",2990,1511,1479,"France",35,17,18,4,2,2,4,2,2,0,0,14,9,5,36,16,20,6,1,147,125,42
"954","Lucas Perez",32,"1988","09","10","2018/2019","Forward","West Ham United",468,287,181,"Spain",15,10,5,3,3,0,0,0,0,0,0,3,2,1,9,5,4,0,0,10,276,-1
"955","Lucas Rodrigues Moura da Silva",28,"1992","08","13","2018/2019","Midfielder","Tottenham Hotspur",2127,1040,1087,"Brazil",32,15,17,10,6,4,0,0,0,0,0,12,7,5,16,9,7,3,0,30,279,-1
"956","Lucas Torreira",25,"1996","02","11","2018/2019","Midfielder","Arsenal",2377,1231,1146,"Uruguay",34,17,17,2,2,0,2,0,2,0,0,6,5,1,35,10,25,8,1,190,174,-1
"957","Luciano Vietto",27,"1993","12","05","2018/2019","Forward","Fulham",983,549,434,"Argentina",20,9,11,1,1,0,4,4,0,0,0,1,1,0,21,11,10,1,0,180,11,-1
"958","Luka Milivojević",29,"1991","04","07","2018/2019","Midfielder","Crystal Palace",3420,1710,1710,"Serbia",38,19,19,12,7,5,2,0,2,10,1,12,7,5,47,20,27,10,0,59,210,-1
"959","Luke Amos",24,"1997","02","23","2018/2019","Midfielder","Tottenham Hotspur",2,0,2,"England",1,0,1,0,0,0,0,0,0,0,0,0,0,0,0,0,0,0,0,-1,-1,-1
"960","Luke Dreher",22,"1998","11","27","2018/2019","Midfielder","Crystal Palace",0,0,0,"England",1,1,0,0,0,0,0,0,0,0,0,0,0,0,0,0,0,0,0,-1,-1,-1
"961","Luke Shaw",25,"1995","07","12","2018/2019","Defender","Manchester United",2592,1170,1422,"England",29,13,16,1,1,0,4,2,2,0,0,6,1,5,36,16,20,11,0,262,105,77
"962","Lys Mousset",25,"1996","02","08","2018/2019","Forward","AFC Bournemouth",345,96,249,"France",24,13,11,1,0,1,0,0,0,0,0,5,4,1,13,4,9,1,0,75,395,-1
"963","Maarten Stekelenburg",38,"1982","09","22","2018/2019","Goalkeeper","Everton",0,0,0,"Netherlands",0,0,0,0,0,0,0,0,0,0,0,0,0,0,0,0,0,0,0,-1,-1,-1
"964","Mamadou Sakho",31,"1990","02","13","2018/2019","Defender","Crystal Palace",2417,1170,1247,"France",27,13,14,0,0,0,0,0,0,0,0,9,5,4,32,10,22,2,0,322,403,64
"965","Manolo Gabbiadini",29,"1991","11","26","2018/2019","Forward","Southampton",470,253,217,"Italy",12,6,6,1,1,0,0,0,0,0,0,3,2,1,11,3,8,0,0,100,357,-1
"966","Manuel Lanzini",28,"1993","02","15","2018/2019","Midfielder","West Ham United",688,367,321,"Argentina",10,5,5,1,0,1,1,0,1,0,0,2,2,0,11,5,6,2,0,130,111,-1
"967","Marc Albrighton",31,"1989","11","18","2018/2019","Midfielder","Leicester City",1626,797,829,"England",27,14,13,2,1,1,2,1,1,0,0,9,5,4,17,8,9,3,0,156,140,-1
"968","Marc Guehi",20,"2000","07","13","2018/2019","Defender","Chelsea",0,0,0,"England",0,0,0,0,0,0,0,0,0,0,0,0,0,0,0,0,0,0,0,-1,-1,-1
"969","Marc Navarro Ceciliano",25,"1995","07","02","2018/2019","Defender","Watford",84,0,84,"Spain",2,0,2,0,0,0,0,0,0,0,0,0,0,0,2,0,2,0,0,-1,-1,-1
"970","Marc Pugh",34,"1987","04","02","2018/2019","Midfielder","AFC Bournemouth",0,0,0,"England",0,0,0,0,0,0,0,0,0,0,0,0,0,0,0,0,0,0,0,-1,-1,-1
"971","Marcos Alonso",30,"1990","12","28","2018/2019","Defender","Chelsea",2761,1338,1423,"Spain",31,15,16,2,1,1,4,3,1,0,0,14,8,6,28,9,19,6,0,191,112,22
"972","Marcus Bettinelli",28,"1992","05","24","2018/2019","Goalkeeper","Fulham",630,270,360,"England",7,3,4,0,0,0,0,0,0,0,0,0,0,0,19,7,12,1,0,296,283,174
"973","Marcus Rashford",23,"1997","10","31","2018/2019","Forward","Manchester United",2362,1293,1069,"England",33,17,16,10,4,6,6,3,3,0,0,6,2,4,34,17,17,4,1,41,52,-1
"974","Mario Lemina",27,"1993","09","01","2018/2019","Midfielder","Southampton",1615,763,852,"Gabon",21,9,12,1,0,1,1,0,1,0,0,4,2,2,32,12,20,5,0,211,195,-1
"975","Mark Noble",33,"1987","05","08","2018/2019","Midfielder","West Ham United",2308,1147,1161,"England",31,15,16,5,2,3,5,4,1,4,0,7,4,3,29,12,17,7,1,96,70,-1
"976","Mark Travers",21,"1999","05","18","2018/2019","Goalkeeper","AFC Bournemouth",180,90,90,"Republic of Ireland",2,1,1,0,0,0,0,0,0,0,0,1,1,0,5,0,5,0,0,-1,-1,-1
"977","Marko Arnautović",31,"1989","04","19","2018/2019","Forward","West Ham United",2000,1083,917,"Austria",28,15,13,10,7,3,4,1,3,1,0,5,3,2,31,17,14,3,0,26,76,-1
"978","Markus Suttner",33,"1987","04","16","2018/2019","Defender","Brighton & Hove Albion",0,0,0,"Austria",0,0,0,0,0,0,0,0,0,0,0,0,0,0,0,0,0,0,0,-1,-1,-1
"979","Marouane Fellaini",33,"1987","11","22","2018/2019","Midfielder","Manchester United",744,217,527,"Belgium",14,6,8,0,0,0,1,0,1,0,0,2,1,1,13,2,11,1,0,341,129,-1
"980","Martin Dúbravka",32,"1989","01","15","2018/2019","Goalkeeper","Newcastle United",3420,1710,1710,"Slovakia",38,19,19,0,0,0,0,0,0,0,0,11,5,6,44,23,21,1,0,345,317,58
"981","Martin Kelly",30,"1990","04","27","2018/2019","Defender","Crystal Palace",1110,660,450,"England",13,8,5,0,0,0,0,0,0,0,0,3,2,1,18,11,7,2,0,326,350,110
"982","Martín Montoya",29,"1991","04","14","2018/2019","Defender","Brighton & Hove Albion",2166,1176,990,"Spain",25,14,11,0,0,0,1,0,1,0,0,3,3,0,38,18,20,4,0,294,229,128
"983","Mason Greenwood",19,"2001","10","01","2018/2019","Midfielder","Manchester United",115,105,10,"England",3,2,1,0,0,0,0,0,0,0,0,0,0,0,2,2,0,0,0,-1,-1,-1
"984","Mason Holgate",24,"1996","10","22","2018/2019","Defender","Everton",407,270,137,"England",5,3,2,0,0,0,0,0,0,0,0,0,0,0,9,5,4,1,0,414,390,160
"985","Matěj Vydra",28,"1992","05","01","2018/2019","Forward","Burnley",311,91,220,"Czech Republic",13,6,7,1,1,0,1,0,1,0,0,1,1,0,4,0,4,1,0,66,23,-1
"986","Mateo Kovačić",26,"1994","05","06","2018/2019","Midfielder","Chelsea",1743,968,775,"Croatia",32,17,15,0,0,0,2,1,1,0,0,12,8,4,18,4,14,3,0,291,150,-1
"987","Mathew Ryan",28,"1992","04","08","2018/2019","Goalkeeper","Brighton & Hove Albion",3060,1530,1530,"Australia",34,17,17,0,0,0,0,0,0,0,0,6,4,2,52,25,27,2,0,398,389,122
"988","Mathias Jattah-Njie Jørgensen",30,"1990","04","23","2018/2019","Defender","Huddersfield Town",2148,1248,900,"Denmark",24,14,10,3,1,2,1,0,1,0,0,3,2,1,37,21,16,6,0,129,235,125
"989","Matt Butcher",23,"1997","05","14","2018/2019","Midfielder","AFC Bournemouth",0,0,0,"England",0,0,0,0,0,0,0,0,0,0,0,0,0,0,0,0,0,0,0,-1,-1,-1
"990","Matt Doherty",29,"1992","01","16","2018/2019","Defender","Wolverhampton Wanderers",3147,1557,1590,"Republic of Ireland",38,19,19,4,1,3,5,4,1,0,0,9,7,2,38,18,20,5,0,155,100,46
"991","Matt Ritchie",31,"1989","09","10","2018/2019","Midfielder","Newcastle United",2940,1557,1383,"Scotland",36,19,17,2,1,1,8,2,6,1,1,11,5,6,37,21,16,9,0,216,46,-1
"992","Matt Targett",25,"1995","09","18","2018/2019","Defender","Southampton",1185,483,702,"England",16,7,9,1,1,0,3,2,1,0,0,1,0,1,24,10,14,2,0,183,51,151
"993","Matteo Darmian",31,"1989","12","02","2018/2019","Defender","Manchester United",443,353,90,"Italy",6,5,1,0,0,0,0,0,0,0,0,1,1,0,7,4,3,0,0,411,280,102
"994","Mattéo Guendouzi Olié",21,"1999","04","14","2018/2019","Midfielder","Arsenal",2143,971,1172,"France",33,14,19,0,0,0,0,0,0,0,0,4,3,1,28,9,19,9,0,386,405,-1
"995","Matthew Connolly",33,"1987","09","24","2018/2019","Defender","Cardiff City",0,0,0,"England",0,0,0,0,0,0,0,0,0,0,0,0,0,0,0,0,0,0,0,-1,-1,-1
"996","Matthew Lowton",31,"1989","06","09","2018/2019","Defender","Burnley",1748,810,938,"England",21,9,12,0,0,0,0,0,0,0,0,4,2,2,35,16,19,7,0,378,342,150
"997","Matty Daly",20,"2001","03","10","2018/2019","Midfielder","Huddersfield Town",73,49,24,"England",2,1,1,0,0,0,0,0,0,0,0,0,0,0,1,1,0,0,0,-1,-1,-1
"998","Max Harrison Sanders",22,"1999","01","04","2018/2019","Midfielder","Brighton & Hove Albion",0,0,0,"England",0,0,0,0,0,0,0,0,0,0,0,0,0,0,0,0,0,0,0,-1,-1,-1
"999","Max Kilman",23,"1997","05","23","2018/2019","Defender","Wolverhampton Wanderers",0,0,0,"England",1,1,0,0,0,0,0,0,0,0,0,1,1,0,0,0,0,0,0,-1,-1,-1
"1000","Max Meyer",25,"1995","09","18","2018/2019","Midfielder","Crystal Palace",1414,718,696,"Germany",29,18,11,1,0,1,2,0,2,0,0,8,7,1,19,5,14,3,0,209,110,-1
"1001","Maxime Le Marchand",31,"1989","10","11","2018/2019","Defender","Fulham",2251,1171,1080,"France",26,14,12,0,0,0,1,1,0,0,0,4,3,1,50,23,27,5,0,314,219,162
"1002","Maya Yoshida",32,"1988","08","24","2018/2019","Defender","Southampton",1520,800,720,"Japan",17,9,8,0,0,0,1,1,0,0,0,3,1,2,27,14,13,0,0,308,192,133
"1003","Mesut Özil",32,"1988","10","15","2018/2019","Midfielder","Arsenal",1741,1139,602,"Germany",24,14,10,5,4,1,2,2,0,0,0,6,5,1,23,11,12,2,0,73,151,-1
"1004","Michael Keane",28,"1993","01","11","2018/2019","Defender","Everton",2970,1350,1620,"England",33,15,18,1,0,1,2,1,1,0,0,13,8,5,37,15,22,2,0,251,196,49
"1005","Michael Obafemi",20,"2000","07","06","2018/2019","Forward","Southampton",134,64,70,"Republic of Ireland",6,2,4,1,0,1,1,1,0,0,0,0,0,0,2,2,0,1,0,-1,-1,-1
"1006","Michail Antonio",31,"1990","03","28","2018/2019","Midfielder","West Ham United",2099,998,1101,"England",33,16,17,6,4,2,4,2,2,0,0,5,3,2,26,10,16,3,0,77,85,-1
"1007","Michel Vorm",37,"1983","10","20","2018/2019","Goalkeeper","Tottenham Hotspur",180,90,90,"Netherlands",2,1,1,0,0,0,0,0,0,0,0,0,0,0,4,2,2,0,0,-1,-1,-1
"1008","Michy Batshuayi",27,"1993","10","02","2018/2019","Forward","Crystal Palace",756,368,388,"Belgium",11,6,5,5,2,3,0,0,0,0,0,3,2,1,11,7,4,0,0,8,307,-1
"1009","Miguel Ángel Almirón Rejala",27,"1994","02","10","2018/2019","Midfielder","Newcastle United",763,405,358,"Paraguay",10,5,5,0,0,0,0,0,0,0,0,3,2,1,10,4,6,0,0,282,311,-1
"1010","Miguel Ángel Britos Cabrera",35,"1985","07","17","2018/2019","Defender","Watford",185,13,172,"Uruguay",3,1,2,0,0,0,0,0,0,0,0,1,1,0,5,0,5,0,0,-1,-1,-1
"1011","Mohamed Diamé",33,"1987","06","14","2018/2019","Midfielder","Newcastle United",2165,960,1205,"Senegal",29,13,16,0,0,0,0,0,0,0,0,9,3,6,28,13,15,3,0,348,267,-1
"1012","Mohamed Elneny",28,"1992","07","11","2018/2019","Midfielder","Arsenal",381,214,167,"Egypt",8,5,3,0,0,0,0,0,0,0,0,2,2,0,4,2,2,0,0,388,409,-1
"1013","Mohamed Elyounoussi",26,"1994","08","04","2018/2019","Midfielder","Southampton",790,393,397,"Norway",16,8,8,0,0,0,0,0,0,0,0,4,2,2,8,5,3,0,0,375,368,-1
"1014","Mohamed Salah",28,"1992","06","15","2018/2019","Forward","Liverpool",3262,1692,1570,"Egypt",38,19,19,22,13,9,8,5,3,3,0,21,12,9,18,8,10,1,0,7,57,-1
"1015","Morgan Gibbs-White",21,"2000","01","27","2018/2019","Midfielder","Wolverhampton Wanderers",647,426,221,"England",26,13,13,0,0,0,1,1,0,0,0,5,5,0,9,5,4,1,0,408,107,-1
"1016","Morgan Schneiderlin",31,"1989","11","08","2018/2019","Midfielder","Everton",833,473,360,"France",14,9,5,0,0,0,1,1,0,0,0,7,5,2,9,5,4,2,0,412,138,-1
"1017","Moussa Dembele",33,"1987","07","16","2018/2019","Midfielder","Tottenham Hotspur",516,161,355,"Belgium",10,3,7,0,0,0,0,0,0,0,0,3,0,3,5,3,2,1,0,355,277,-1
"1018","Moussa Sissoko",31,"1989","08","16","2018/2019","Midfielder","Tottenham Hotspur",2336,1187,1149,"France",29,15,14,0,0,0,3,2,1,0,0,11,6,5,26,10,16,2,0,354,131,-1
"1019","N'Golo Kanté",30,"1991","03","29","2018/2019","Midfielder","Chelsea",3096,1579,1517,"France",36,19,17,4,2,2,4,3,1,0,0,15,10,5,37,12,25,3,0,141,126,-1
"1020","Naby Deco Keïta",26,"1995","02","10","2018/2019","Midfielder","Liverpool",1392,729,663,"Guinea",25,14,11,2,1,1,1,1,0,0,0,15,10,5,7,4,3,0,0,138,190,-1
"1021","Nacho Monreal",35,"1986","02","26","2018/2019","Defender","Arsenal",1861,781,1080,"Spain",22,10,12,1,1,0,3,0,3,0,0,6,5,1,21,3,18,5,0,222,98,37
"1022","Nampalys Mendy",28,"1992","06","23","2018/2019","Midfielder","Leicester City",2088,1006,1082,"France",31,16,15,0,0,0,0,0,0,0,0,9,5,4,26,11,15,5,0,271,397,-1
"1023","Nathan Aké",26,"1995","02","18","2018/2019","Defender","AFC Bournemouth",3412,1710,1702,"Netherlands",38,19,19,4,3,1,0,0,0,0,0,10,6,4,66,23,43,3,0,150,337,148
"1024","Nathan Holland",22,"1998","06","19","2018/2019","Midfielder","West Ham United",0,0,0,"England",0,0,0,0,0,0,0,0,0,0,0,0,0,0,0,0,0,0,0,-1,-1,-1
"1025","Nathan Redmond",27,"1994","03","06","2018/2019","Midfielder","Southampton",3276,1633,1643,"England",38,19,19,6,4,2,4,2,2,0,0,7,3,4,53,22,31,3,0,116,137,-1
"1026","Nathaniel Chalobah",26,"1994","12","12","2018/2019","Midfielder","Watford",266,67,199,"England",9,3,6,0,0,0,0,0,0,0,0,1,1,0,5,2,3,2,0,-1,-1,-1
"1027","Nathaniel Clyne",30,"1991","04","05","2018/2019","Defender","AFC Bournemouth",1254,684,570,"England",18,10,8,0,0,0,1,0,1,0,0,6,4,2,24,6,18,2,0,392,180,146
"1028","Nathaniel Mendez-Laing",28,"1992","04","15","2018/2019","Midfielder","Cardiff City",984,442,542,"England",20,9,11,4,0,4,1,1,0,1,0,6,3,3,15,8,7,0,0,46,159,-1
"1029","Neeskens Kebano",29,"1992","03","10","2018/2019","Midfielder","Fulham",103,74,29,"Congo DR",7,5,2,0,0,0,0,0,0,0,0,0,0,0,1,0,1,0,0,-1,-1,-1
"1030","Neil Leonard Dula Etheridge",31,"1990","02","07","2018/2019","Goalkeeper","Cardiff City",3420,1710,1710,"Philippines",38,19,19,0,0,0,0,0,0,0,0,10,5,5,61,34,27,2,0,363,392,134
"1031","Nemanja Matić",32,"1988","08","01","2018/2019","Midfielder","Manchester United",2441,1051,1390,"Serbia",28,12,16,1,1,0,0,0,0,0,0,6,1,5,35,14,21,8,1,239,257,-1
"1032","Nicolas Otamendi",33,"1988","02","12","2018/2019","Defender","Manchester City",1233,682,551,"Argentina",18,9,9,0,0,0,0,0,0,0,0,10,3,7,7,6,1,1,0,273,385,4
"1033","Nikola Tavares",22,"1999","01","17","2018/2019","Defender","Crystal Palace",0,0,0,"England",0,0,0,0,0,0,0,0,0,0,0,0,0,0,0,0,0,0,0,-1,-1,-1
"1034","Nnamdi Ofoborh",21,"1999","11","07","2018/2019","Midfielder","AFC Bournemouth",0,0,0,"England",0,0,0,0,0,0,0,0,0,0,0,0,0,0,0,0,0,0,0,-1,-1,-1
"1035","Oleksandr Zinchenko",24,"1996","12","15","2018/2019","Midfielder","Manchester City",1153,613,540,"Ukraine",14,8,6,0,0,0,3,2,1,0,0,10,6,4,4,2,2,1,0,284,50,-1
"1036","Oliver Skipp",20,"2000","09","16","2018/2019","Midfielder","Tottenham Hotspur",216,191,25,"England",8,6,2,0,0,0,0,0,0,0,0,4,3,1,0,0,0,0,0,-1,-1,-1
"1037","Olivier Giroud",34,"1986","09","30","2018/2019","Forward","Chelsea",832,446,386,"France",27,14,13,2,1,1,4,3,1,0,0,12,7,5,4,1,3,1,0,86,7,-1
"1038","Onyinye Wilfred Ndidi",24,"1996","12","16","2018/2019","Midfielder","Leicester City",3299,1624,1675,"Nigeria",38,19,19,2,2,0,0,0,0,0,0,10,6,4,42,18,24,8,0,218,332,-1
"1039","Oriol Romeu",29,"1991","09","24","2018/2019","Midfielder","Southampton",2140,1110,1030,"Spain",31,16,15,1,1,0,0,0,0,0,0,6,3,3,32,16,16,11,0,244,371,-1
"1040","Oumar Niasse",30,"1990","04","18","2018/2019","Forward","Cardiff City",998,435,563,"Senegal",18,8,10,0,0,0,0,0,0,0,0,3,2,1,12,5,7,0,0,415,388,-1
"1041","Pablo Zabaleta",36,"1985","01","16","2018/2019","Defender","West Ham United",2092,1216,876,"Argentina",26,14,12,0,0,0,1,1,0,0,0,4,2,2,32,22,10,4,0,370,223,99
"1042","Pape N'Diaye Souaré",30,"1990","06","06","2018/2019","Defender","Crystal Palace",0,0,0,"Senegal",1,0,1,0,0,0,0,0,0,0,0,1,0,1,0,0,0,0,0,-1,-1,-1
"1043","Pascal Groß",29,"1991","06","15","2018/2019","Midfielder","Brighton & Hove Albion",1878,993,885,"Germany",25,13,12,3,2,1,3,1,2,1,1,3,2,1,31,16,15,1,0,126,104,-1
"1044","Patrick van Aanholt",30,"1990","08","29","2018/2019","Defender","Crystal Palace",3198,1703,1495,"Netherlands",36,19,17,3,2,1,2,0,2,0,0,12,7,5,41,19,22,3,0,184,199,53
"1045","Paul Dummett",29,"1991","09","26","2018/2019","Defender","Newcastle United",1986,979,1007,"Wales",26,13,13,0,0,0,0,0,0,0,0,9,3,6,27,15,12,1,0,347,269,69
"1046","Paul Pogba",28,"1993","03","15","2018/2019","Midfielder","Manchester United",3011,1517,1494,"France",35,18,17,13,10,3,9,4,5,7,3,7,2,5,41,20,21,6,0,37,30,-1
"1047","Paulo Dino Gazzaniga",29,"1992","01","02","2018/2019","Goalkeeper","Tottenham Hotspur",270,0,270,"Argentina",3,0,3,0,0,0,0,0,0,0,0,1,0,1,1,0,1,0,0,-1,-1,-1
"1048","Pedro Obiang",29,"1992","03","27","2018/2019","Midfielder","West Ham United",1121,609,512,"Equatorial Guinea",24,13,11,0,0,0,1,0,1,0,0,7,4,3,17,9,8,0,0,371,168,-1
"1049","Pedro Rodriguez",33,"1987","07","28","2018/2019","Midfielder","Chelsea",1780,958,822,"Spain",31,15,16,8,6,2,2,2,0,0,0,11,7,4,18,7,11,2,0,35,144,-1
"1050","Peter Crouch",40,"1981","01","30","2018/2019","Forward","Burnley",86,56,30,"England",6,4,2,0,0,0,0,0,0,0,0,0,0,0,0,0,0,1,0,-1,-1,-1
"1051","Petr Čech",38,"1982","05","20","2018/2019","Goalkeeper","Arsenal",585,315,270,"Czech Republic",7,4,3,0,0,0,0,0,0,0,0,2,2,0,8,3,5,0,0,384,377,71
"1052","Phil Bardsley",35,"1985","06","28","2018/2019","Defender","Burnley",1672,900,772,"Scotland",19,10,9,0,0,0,0,0,0,0,0,4,3,1,22,11,11,9,0,383,355,62
"1053","Phil Jagielka",38,"1982","08","17","2018/2019","Defender","Everton",329,95,234,"England",7,3,4,1,1,0,0,0,0,0,0,5,3,2,2,0,2,1,1,71,272,9
"1054","Phil Jones",29,"1992","02","21","2018/2019","Defender","Manchester United",1263,652,611,"England",18,9,9,0,0,0,1,0,1,0,0,4,0,4,16,9,7,1,0,299,189,51
"1055","Philip Billing",24,"1996","06","11","2018/2019","Midfielder","Huddersfield Town",2192,1106,1086,"Denmark",27,13,14,2,1,1,0,0,0,0,0,5,3,2,41,17,24,7,0,185,372,-1
"1056","Philip Foden",20,"2000","05","28","2018/2019","Midfielder","Manchester City",327,279,48,"England",13,10,3,1,1,0,0,0,0,0,0,8,6,2,0,0,0,0,0,67,386,-1
"1057","Philippe Sandler",24,"1997","02","10","2018/2019","Defender","Manchester City",0,0,0,"Netherlands",0,0,0,0,0,0,0,0,0,0,0,0,0,0,0,0,0,0,0,-1,-1,-1
"1058","Pierre-Emerick Aubameyang",31,"1989","06","18","2018/2019","Forward","Arsenal",2731,1418,1313,"Gabon",36,19,17,22,13,9,5,4,1,4,1,8,7,1,40,14,26,0,0,3,88,-1
"1059","Pierre-Emile Højbjerg",25,"1995","08","05","2018/2019","Midfielder","Southampton",2764,1416,1348,"Denmark",31,16,15,4,2,2,3,2,1,0,0,4,1,3,52,23,29,10,2,136,148,-1
"1060","Rachid Ghezzal",28,"1992","05","09","2018/2019","Forward","Leicester City",738,455,283,"Algeria",19,12,7,1,1,0,0,0,0,0,0,3,2,1,12,6,6,3,0,140,322,-1
"1061","Rafael Euclides Soares Camacho",20,"2000","05","22","2018/2019","Midfielder","Liverpool",0,0,0,"Portugal",1,1,0,0,0,0,0,0,0,0,0,0,0,0,0,0,0,0,0,-1,-1,-1
"1062","Raheem Sterling",26,"1994","12","08","2018/2019","Forward","Manchester City",2777,1256,1521,"England",34,16,18,17,12,5,10,6,4,0,0,18,7,11,19,9,10,3,0,12,14,-1
"1063","Rajiv van La Parra",29,"1991","06","04","2018/2019","Midfielder","Huddersfield Town",407,168,239,"Netherlands",5,2,3,0,0,0,0,0,0,0,0,1,1,0,6,1,5,0,0,335,396,-1
"1064","Ramadan Sobhi",24,"1997","01","23","2018/2019","Forward","Huddersfield Town",75,30,45,"Egypt",4,1,3,0,0,0,0,0,0,0,0,0,0,0,1,0,1,0,0,-1,-1,-1
"1065","Raúl Alonso Jiménez Rodríguez",29,"1991","05","05","2018/2019","Forward","Wolverhampton Wanderers",3124,1648,1476,"Mexico",38,19,19,13,8,5,7,4,3,2,0,9,7,2,39,20,19,4,0,42,63,-1
"1066","Rhys Healey",26,"1994","12","06","2018/2019","Forward","Cardiff City",49,17,32,"England",3,1,2,0,0,0,0,0,0,0,0,1,1,0,1,0,1,0,0,-1,-1,-1
"1067","Ricardo Domingos Barbosa Pereira",27,"1993","10","06","2018/2019","Defender","Leicester City",3125,1526,1599,"Portugal",35,17,18,2,2,0,6,3,3,0,0,10,6,4,40,16,24,7,0,214,84,52
"1068","Richarlison de Andrade",23,"1997","05","10","2018/2019","Forward","Everton",2679,1283,1396,"Brazil",35,17,18,13,7,6,1,1,0,0,0,14,9,5,32,15,17,6,1,28,250,-1
"1069","Riyad Mahrez",30,"1991","02","21","2018/2019","Midfielder","Manchester City",1339,647,692,"Algeria",27,14,13,7,1,6,4,2,2,0,1,13,6,7,9,4,5,0,0,22,32,-1
"1070","Rob Holding",25,"1995","09","20","2018/2019","Defender","Arsenal",807,501,306,"England",10,6,4,0,0,0,0,0,0,0,0,2,2,0,10,5,5,1,0,389,411,47
"1071","Robbie Brady",29,"1992","01","14","2018/2019","Midfielder","Burnley",715,390,325,"Republic of Ireland",16,9,7,0,0,0,1,0,1,0,0,2,1,1,12,8,4,4,1,268,108,-1
"1072","Robert Kenedy Nunes do Nascimento",25,"1996","02","08","2018/2019","Midfielder","Newcastle United",1344,611,733,"Brazil",25,13,12,1,0,1,1,1,0,0,1,8,3,5,17,9,8,1,0,193,184,-1
"1073","Robert Snodgrass",33,"1987","09","07","2018/2019","Midfielder","West Ham United",2222,1108,1114,"Scotland",33,16,17,2,1,1,5,4,1,0,0,6,3,3,31,16,15,10,0,188,64,-1
"1074","Roberto Firmino",29,"1991","10","02","2018/2019","Forward","Liverpool",2620,1347,1273,"Brazil",34,16,18,12,7,5,6,3,3,1,0,18,9,9,13,7,6,0,0,32,62,-1
"1075","Roberto Maximiliano Pereyra",30,"1991","01","07","2018/2019","Forward","Watford",2825,1467,1358,"Argentina",33,17,16,6,5,1,1,0,1,0,0,5,3,2,52,27,25,3,0,97,251,-1
"1076","Romain Saïss",31,"1990","03","26","2018/2019","Midfielder","Wolverhampton Wanderers",1144,544,600,"Morocco",19,8,11,2,1,1,0,0,0,0,0,4,3,1,16,6,10,7,0,115,264,-1
"1077","Romelu Lukaku",27,"1993","05","13","2018/2019","Forward","Manchester United",2130,982,1148,"Belgium",32,16,16,12,4,8,0,0,0,0,0,7,2,5,36,14,22,4,0,16,305,-1
"1078","Rondon",31,"1989","09","16","2018/2019","Forward","Newcastle United",2609,1343,1266,"Venezuela",32,16,16,11,6,5,7,5,2,0,0,10,5,5,29,14,15,1,0,40,43,-1
"1079","Ross Barkley",27,"1993","12","05","2018/2019","Midfielder","Chelsea",1241,432,809,"England",27,11,16,3,1,2,5,2,3,0,0,11,5,6,13,5,8,1,0,84,12,-1
"1080","Rúben Diogo Da Silva Neves",24,"1997","03","13","2018/2019","Midfielder","Wolverhampton Wanderers",3009,1451,1558,"Portugal",35,17,18,4,3,1,3,2,1,2,0,8,6,2,40,19,21,8,0,145,162,-1
"1081","Rúben Gonçalo Silva Nascimento Vinagre",22,"1999","04","09","2018/2019","Defender","Wolverhampton Wanderers",703,514,189,"Portugal",17,12,5,0,0,0,0,0,0,0,0,5,4,1,9,6,3,1,0,406,323,54
"1082","Ruben Loftus-Cheek",25,"1996","01","23","2018/2019","Midfielder","Chelsea",983,507,476,"England",24,12,12,6,3,3,2,2,0,0,0,12,9,3,8,2,6,0,0,11,83,-1
"1083","Rui Pedro dos Santos Patrício",33,"1988","02","15","2018/2019","Goalkeeper","Wolverhampton Wanderers",3330,1620,1710,"Portugal",37,18,19,0,0,0,0,0,0,0,0,8,6,2,43,20,23,0,0,405,328,56
"1084","Ryan Bennett",31,"1990","03","06","2018/2019","Defender","Wolverhampton Wanderers",3060,1710,1350,"England",34,19,15,1,1,0,0,0,0,0,0,9,7,2,36,20,16,12,0,256,304,40
"1085","Ryan Bertrand",31,"1989","08","05","2018/2019","Defender","Southampton",2160,1170,990,"England",24,13,11,1,1,0,0,0,0,0,0,6,3,3,36,15,21,8,0,245,366,117
"1086","Ryan Fraser",27,"1994","02","24","2018/2019","Midfielder","AFC Bournemouth",3173,1605,1568,"Scotland",38,19,19,7,5,2,14,5,9,0,0,10,6,4,61,23,38,2,0,95,9,-1
"1087","Ryan Fredericks",28,"1992","10","10","2018/2019","Midfielder","West Ham United",1085,404,681,"England",15,5,10,1,1,0,0,0,0,0,0,3,2,1,13,1,12,5,0,189,340,-1
"1088","Ryan Giles",21,"2000","01","26","2018/2019","Midfielder","Wolverhampton Wanderers",0,0,0,"England",0,0,0,0,0,0,0,0,0,0,0,0,0,0,0,0,0,0,0,-1,-1,-1
"1089","Ryan Guno Babel",34,"1986","12","19","2018/2019","Forward","Fulham",1260,668,592,"Netherlands",16,9,7,5,3,2,3,3,0,0,0,3,2,1,24,12,12,3,0,47,61,-1
"1090","Ryan Schofield",21,"1999","12","11","2018/2019","Goalkeeper","Huddersfield Town",0,0,0,"England",0,0,0,0,0,0,0,0,0,0,0,0,0,0,0,0,0,0,0,-1,-1,-1
"1091","Ryan Sessegnon",20,"2000","05","18","2018/2019","Defender","Fulham",2298,1095,1203,"England",35,18,17,2,1,1,6,3,3,0,0,4,3,1,58,22,36,0,0,182,53,168
"1092","Sadio Mané",28,"1992","04","10","2018/2019","Forward","Liverpool",3086,1643,1443,"Senegal",36,19,17,22,18,4,1,0,1,0,0,20,12,8,18,8,10,2,0,4,249,-1
"1093","Sam Gallagher",25,"1995","09","15","2018/2019","Forward","Southampton",30,7,23,"England",4,1,3,0,0,0,0,0,0,0,0,1,0,1,0,0,0,0,0,-1,-1,-1
"1094","Sam Surridge",22,"1998","07","28","2018/2019","Forward","AFC Bournemouth",11,0,11,"England",2,0,2,0,0,0,0,0,0,0,0,0,0,0,0,0,0,0,0,-1,-1,-1
"1095","Sam Vokes",31,"1989","10","21","2018/2019","Forward","Burnley",913,455,458,"Wales",20,10,10,3,2,1,0,0,0,0,0,4,2,2,18,9,9,0,0,64,351,-1
"1096","Sam Woods",22,"1998","09","11","2018/2019","Defender","Crystal Palace",0,0,0,"England",0,0,0,0,0,0,0,0,0,0,0,0,0,0,0,0,0,0,0,-1,-1,-1
"1097","Samir Nasri",33,"1987","06","26","2018/2019","Midfielder","West Ham United",246,102,144,"France",5,2,3,0,0,0,2,2,0,0,0,1,1,0,2,1,1,0,0,-1,-1,-1
"1098","Sandro Ramirez",25,"1995","07","09","2018/2019","Forward","Everton",0,0,0,"Spain",0,0,0,0,0,0,0,0,0,0,0,0,0,0,0,0,0,0,0,-1,-1,-1
"1099","Scott Dann",34,"1987","02","14","2018/2019","Defender","Crystal Palace",660,360,300,"England",10,4,6,0,0,0,1,0,1,0,0,3,2,1,7,4,3,1,0,276,101,24
"1100","Scott McTominay",24,"1996","12","08","2018/2019","Midfielder","Manchester United",861,345,516,"England",16,7,9,2,0,2,0,0,0,0,0,3,1,2,17,6,11,1,0,91,303,-1
"1101","Sead Kolašinac",27,"1993","06","20","2018/2019","Defender","Arsenal",1891,1127,764,"Bosnia and Herzegovina",24,14,10,0,0,0,5,3,2,0,0,5,5,0,26,10,16,5,0,285,45,75
"1102","Séamus Coleman",32,"1988","10","11","2018/2019","Defender","Everton",2560,1333,1227,"Republic of Ireland",29,15,14,2,2,0,2,0,2,0,0,13,8,5,29,15,14,1,0,197,178,34
"1103","Sean Longstaff",23,"1997","10","30","2018/2019","Midfielder","Newcastle United",688,355,333,"England",9,4,5,1,1,0,0,0,0,0,0,3,3,0,8,1,7,2,0,135,263,-1
"1104","Sean Morrison",30,"1991","01","08","2018/2019","Defender","Cardiff City",3040,1600,1440,"England",34,18,16,1,0,1,3,2,1,0,0,9,4,5,57,34,23,6,0,255,164,140
"1105","Sebastian Prödl",33,"1987","06","21","2018/2019","Defender","Watford",13,0,13,"Austria",1,0,1,0,0,0,0,0,0,0,0,1,0,1,0,0,0,0,0,-1,-1,-1
"1106","Serge Aurier",28,"1992","12","24","2018/2019","Defender","Tottenham Hotspur",564,136,428,"Côte d'Ivoire",8,2,6,0,0,0,2,0,2,0,0,3,0,3,9,2,7,1,0,351,15,108
"1107","Sergio Aguero",32,"1988","06","02","2018/2019","Forward","Manchester City",2480,1125,1355,"Argentina",33,16,17,21,15,6,8,5,3,2,0,19,8,11,15,8,7,3,0,1,28,-1
"1108","Sergio Germán Romero",34,"1987","02","22","2018/2019","Goalkeeper","Manchester United",0,0,0,"Argentina",0,0,0,0,0,0,0,0,0,0,0,0,0,0,0,0,0,0,0,-1,-1,-1
"1109","Sergio Rico",27,"1993","09","01","2018/2019","Goalkeeper","Fulham",2610,1350,1260,"Spain",29,15,14,0,0,0,0,0,0,0,0,5,3,2,53,24,29,1,0,320,406,153
"1110","Shane Duffy",29,"1992","01","01","2018/2019","Defender","Brighton & Hove Albion",3088,1558,1530,"Republic of Ireland",35,18,17,5,2,3,1,1,0,0,0,7,5,2,51,23,28,5,1,123,253,115
"1111","Shane Long",34,"1987","01","22","2018/2019","Forward","Southampton",1269,629,640,"Republic of Ireland",26,15,11,5,3,2,1,1,0,0,0,5,2,3,20,7,13,3,0,51,182,-1
"1112","Shinji Okazaki",34,"1986","04","16","2018/2019","Forward","Leicester City",269,126,143,"Japan",21,13,8,0,0,0,1,0,1,0,0,2,2,0,1,0,1,0,0,-1,-1,-1
"1113","Shkodran Mustafi",28,"1992","04","17","2018/2019","Defender","Arsenal",2617,1263,1354,"Germany",31,15,16,2,0,2,0,0,0,0,0,6,5,1,36,12,24,9,0,201,378,74
"1114","Simon Francis",36,"1985","02","16","2018/2019","Defender","AFC Bournemouth",1226,675,551,"England",17,9,8,0,0,0,2,1,1,0,0,5,3,2,23,11,12,1,0,360,99,138
"1115","Simon Mignolet",33,"1988","03","06","2018/2019","Goalkeeper","Liverpool",0,0,0,"Belgium",0,0,0,0,0,0,0,0,0,0,0,0,0,0,0,0,0,0,0,-1,-1,-1
"1116","Sokratis Papastathopoulos",32,"1988","06","09","2018/2019","Defender","Arsenal",2199,1119,1080,"Greece",25,13,12,1,0,1,2,2,0,0,0,6,6,0,31,9,22,12,0,234,173,82
"1117","Solomon March",26,"1994","07","20","2018/2019","Midfielder","Brighton & Hove Albion",2473,1153,1320,"England",35,16,19,1,1,0,5,1,4,0,0,6,4,2,39,13,26,1,0,242,82,-1
"1118","Souleymane Bamba",36,"1985","01","13","2018/2019","Defender","Cardiff City",2475,1260,1215,"Côte d'Ivoire",28,14,14,4,2,2,1,1,0,0,0,7,4,3,46,23,23,7,0,118,222,136
"1119","Stefan Marius Johansen",30,"1991","01","08","2018/2019","Midfielder","Fulham",412,130,282,"Norway",12,5,7,0,0,0,0,0,0,0,0,0,0,0,11,1,10,4,0,318,401,-1
"1120","Stefano Okaka",31,"1989","08","09","2018/2019","Forward","Watford",22,9,13,"Italy",2,1,1,0,0,0,0,0,0,0,0,0,0,0,1,1,0,1,0,-1,-1,-1
"1121","Stephan Lichtsteiner",37,"1984","01","16","2018/2019","Defender","Arsenal",940,408,532,"Switzerland",14,7,7,0,0,0,0,0,0,0,0,2,2,0,18,4,14,3,0,387,407,147
"1122","Stephen Ward",35,"1985","08","20","2018/2019","Defender","Burnley",230,74,156,"Republic of Ireland",3,1,2,0,0,0,0,0,0,0,0,1,0,1,6,3,3,1,0,-1,-1,-1
"1123","Steve Cook",29,"1991","04","19","2018/2019","Defender","AFC Bournemouth",2787,1350,1437,"England",31,15,16,1,0,1,1,0,1,0,0,9,6,3,53,17,36,3,0,254,243,145
"1124","Steve Mounié",26,"1994","09","29","2018/2019","Forward","Huddersfield Town",1777,1009,768,"Benin",31,16,15,2,2,0,3,1,2,0,0,5,3,2,34,15,19,2,1,168,90,-1
"1125","Steven Davis",36,"1985","01","01","2018/2019","Midfielder","Southampton",96,6,90,"Northern Ireland",3,2,1,0,0,0,1,0,1,0,0,0,0,0,3,0,3,0,0,-1,-1,-1
"1126","Steven Defour",32,"1988","04","15","2018/2019","Midfielder","Burnley",452,172,280,"Belgium",6,2,4,0,0,0,0,0,0,0,0,1,0,1,12,5,7,0,0,264,321,-1
"1127","Stuart Armstrong",29,"1992","03","30","2018/2019","Midfielder","Southampton",1432,469,963,"Scotland",29,11,18,3,1,2,2,1,1,0,0,4,1,3,23,8,15,2,0,98,114,-1
"1128","Sullay Kaikai",25,"1995","08","26","2018/2019","Midfielder","Crystal Palace",0,0,0,"England",0,0,0,0,0,0,0,0,0,0,0,0,0,0,0,0,0,0,0,-1,-1,-1
"1129","Sung-Yeung Ki",32,"1989","01","24","2018/2019","Midfielder","Newcastle United",1302,824,478,"South Korea",18,10,8,0,0,0,1,1,0,0,0,5,2,3,18,12,6,2,0,349,179,-1
"1130","Tahith Chong",21,"1999","12","04","2018/2019","Forward","Manchester United",36,0,36,"Netherlands",2,1,1,0,0,0,0,0,0,0,0,0,0,0,1,0,1,0,0,-1,-1,-1
"1131","Terence Kongolo",27,"1994","02","14","2018/2019","Defender","Huddersfield Town",2722,1405,1317,"Netherlands",32,17,15,1,0,1,1,0,1,0,0,4,3,1,62,27,35,4,0,261,236,165
"1132","Theo Walcott",32,"1989","03","16","2018/2019","Forward","Everton",2122,1114,1008,"England",37,19,18,5,3,2,2,2,0,0,0,13,9,4,33,18,15,1,0,90,170,-1
"1133","Tim Ream",33,"1987","10","05","2018/2019","Defender","Fulham",2051,943,1108,"USA",26,13,13,0,0,0,0,0,0,0,0,5,3,2,47,18,29,1,0,265,320,167
"1134","Timothy Eyoma",21,"2000","01","29","2018/2019","Defender","Tottenham Hotspur",0,0,0,"England",0,0,0,0,0,0,0,0,0,0,0,0,0,0,0,0,0,0,0,-1,-1,-1
"1135","Timothy Fosu-Mensah",23,"1998","01","02","2018/2019","Defender","Fulham",795,499,296,"Netherlands",12,6,6,0,0,0,0,0,0,0,0,1,1,0,18,9,9,3,0,319,408,164
"1136","Toby Alderweireld",32,"1989","03","02","2018/2019","Defender","Tottenham Hotspur",2924,1549,1375,"Belgium",34,18,16,0,0,0,0,0,0,0,0,12,6,6,28,15,13,3,0,356,275,20
"1137","Tom Cairney",30,"1991","01","20","2018/2019","Midfielder","Fulham",2198,1107,1091,"Scotland",31,16,15,1,1,0,1,1,0,0,0,4,3,1,49,21,28,0,0,238,217,-1
"1138","Tom Cleverley",31,"1989","08","12","2018/2019","Midfielder","Watford",470,102,368,"England",13,4,9,1,0,1,0,0,0,0,0,4,2,2,7,0,7,2,0,99,298,-1
"1139","Tom Davies",22,"1998","06","30","2018/2019","Midfielder","Everton",975,520,455,"England",16,8,8,0,0,0,0,0,0,0,0,5,3,2,18,12,6,3,0,416,380,-1
"1140","Tom Heaton",34,"1986","04","15","2018/2019","Goalkeeper","Burnley",1710,900,810,"England",19,10,9,0,0,0,0,0,0,0,0,4,3,1,23,10,13,3,0,382,354,68
"1141","Tom Smith",28,"1992","04","14","2018/2019","Defender","Huddersfield Town",1141,431,710,"England",15,6,9,0,0,0,0,0,0,0,0,1,0,1,34,12,22,3,1,334,360,173
"1142","Trent Alexander-Arnold",22,"1998","10","07","2018/2019","Defender","Liverpool",2467,1266,1201,"England",29,15,14,1,0,1,12,8,4,0,0,16,11,5,14,4,10,3,0,233,6,6
"1143","Troy Deeney",32,"1988","06","29","2018/2019","Forward","Watford",2548,1298,1250,"England",32,16,16,9,3,6,5,1,4,1,0,5,3,2,43,23,20,5,1,57,81,-1
"1144","Tyias Browning",26,"1994","05","27","2018/2019","Defender","Everton",0,0,0,"England",0,0,0,0,0,0,0,0,0,0,0,0,0,0,0,0,0,0,0,-1,-1,-1
"1145","Tyreke Johnson",22,"1998","11","03","2018/2019","Defender","Southampton",0,0,0,"England",1,1,0,0,0,0,0,0,0,0,0,0,0,0,0,0,0,0,0,-1,-1,-1
"1146","Tyrone Mings",28,"1993","03","13","2018/2019","Defender","AFC Bournemouth",141,7,134,"England",5,2,3,0,0,0,0,0,0,0,0,0,0,0,4,0,4,0,0,-1,-1,-1
"1147","Vicente Guaita",34,"1987","01","10","2018/2019","Goalkeeper","Crystal Palace",1755,1035,720,"Spain",20,12,8,0,0,0,0,0,0,0,0,7,5,2,21,12,9,2,0,325,352,45
"1148","Vicente Iborra De La Fuente",33,"1988","01","16","2018/2019","Midfielder","Leicester City",226,152,74,"Spain",8,3,5,0,0,0,0,0,0,0,0,3,1,2,4,2,2,0,0,-1,-1,-1
"1149","Víctor Camarasa",26,"1994","05","28","2018/2019","Midfielder","Cardiff City",2579,1267,1312,"Spain",32,16,16,5,4,1,4,1,3,1,0,8,4,4,48,25,23,6,0,111,106,-1
"1150","Victor Moses",30,"1990","12","12","2018/2019","Midfielder","Chelsea",26,17,9,"Nigeria",2,1,1,0,0,0,0,0,0,0,0,1,0,1,1,1,0,0,0,-1,-1,-1
"1151","Victor Nilsson Lindelöf",26,"1994","07","17","2018/2019","Defender","Manchester United",2602,1112,1490,"Sweden",30,13,17,1,1,0,1,0,1,0,0,6,2,4,38,13,25,1,0,263,246,88
"1152","Victor Wanyama",29,"1991","06","25","2018/2019","Midfielder","Tottenham Hotspur",509,302,207,"Kenya",13,9,4,1,1,0,0,0,0,0,0,6,4,2,3,3,0,2,0,106,266,-1
"1153","Viktor Gyökeres",22,"1998","06","04","2018/2019","Forward","Brighton & Hove Albion",0,0,0,"Sweden",0,0,0,0,0,0,0,0,0,0,0,0,0,0,0,0,0,0,0,-1,-1,-1
"1154","Vincent Janssen",26,"1994","06","15","2018/2019","Forward","Tottenham Hotspur",36,36,0,"Netherlands",3,3,0,0,0,0,0,0,0,0,0,1,1,0,0,0,0,0,0,-1,-1,-1
"1155","Vincent Kompany",34,"1986","04","10","2018/2019","Defender","Manchester City",1223,561,662,"Belgium",17,8,9,1,1,0,0,0,0,0,0,7,3,4,7,3,4,6,0,194,384,7
"1156","Virgil van Dijk",29,"1991","07","08","2018/2019","Defender","Liverpool",3385,1675,1710,"Netherlands",38,19,19,4,2,2,2,1,1,0,0,21,12,9,19,8,11,1,0,152,201,5
"1157","Wayne Hennessey",34,"1987","01","24","2018/2019","Goalkeeper","Crystal Palace",1575,675,900,"Wales",18,8,10,0,0,0,0,0,0,0,0,5,2,3,23,8,15,0,0,321,404,87
"1158","Wes Morgan",37,"1984","01","21","2018/2019","Defender","Leicester City",1926,783,1143,"Jamaica",22,9,13,3,1,2,0,0,0,0,0,6,3,3,24,9,15,5,2,125,300,48
"1159","Wesley Hoedt",27,"1994","03","06","2018/2019","Defender","Southampton",1170,540,630,"Netherlands",13,6,7,0,0,0,0,0,0,0,0,4,2,2,20,5,15,2,0,374,370,123
"1160","Wilfredo Daniel Caballero",39,"1981","09","28","2018/2019","Goalkeeper","Chelsea",180,90,90,"Argentina",2,1,1,0,0,0,0,0,0,0,0,2,1,1,0,0,0,0,0,-1,-1,-1
"1161","Wilfried Zaha",28,"1992","11","10","2018/2019","Midfielder","Crystal Palace",3041,1347,1694,"Côte d'Ivoire",34,15,19,10,1,9,5,3,2,0,0,10,5,5,45,18,27,10,1,63,92,-1
"1162","Will Hughes",25,"1995","04","17","2018/2019","Midfielder","Watford",2436,1251,1185,"England",32,16,16,2,1,1,4,2,2,0,0,5,3,2,39,19,20,5,0,199,91,-1
"1163","Will Norris",27,"1993","08","12","2018/2019","Goalkeeper","Wolverhampton Wanderers",0,0,0,"England",1,1,0,0,0,0,0,0,0,0,0,1,1,0,0,0,0,0,0,-1,-1,-1
"1164","Willian",32,"1988","08","09","2018/2019","Forward","Chelsea",2108,833,1275,"Brazil",32,15,17,3,2,1,6,3,3,0,0,13,7,6,23,6,17,2,0,132,36,-1
"1165","Willy Boly",30,"1991","02","03","2018/2019","Defender","Wolverhampton Wanderers",3169,1530,1639,"France",36,17,19,4,2,2,0,0,0,0,0,8,6,2,38,17,21,3,1,148,312,43
"1166","Xherdan Shaqiri",29,"1991","10","10","2018/2019","Midfielder","Liverpool",1058,538,520,"Switzerland",24,12,12,6,5,1,3,0,3,0,0,12,7,5,5,3,2,2,0,15,39,-1
"1167","Yann Valery",22,"1999","02","22","2018/2019","Defender","Southampton",1715,1070,645,"France",23,13,10,2,1,1,1,1,0,0,0,3,1,2,26,17,9,5,1,162,214,95
"1168","Yerry Fernando Mina González",26,"1994","09","23","2018/2019","Defender","Everton",890,360,530,"Colombia",13,6,7,1,0,1,0,0,0,0,0,4,3,1,12,3,9,3,0,161,329,67
"1169","Yoshinori Muto",28,"1992","07","15","2018/2019","Forward","Newcastle United",516,180,336,"Japan",17,8,9,1,0,1,0,0,0,0,0,5,1,4,10,3,7,1,0,113,290,-1
"1170","Youri Tielemans",23,"1997","05","07","2018/2019","Midfielder","Leicester City",1092,575,517,"Belgium",13,7,6,3,2,1,4,2,2,0,0,3,3,0,13,5,8,2,0,80,13,-1
"1171","Yves Bissouma",24,"1996","08","30","2018/2019","Midfielder","Brighton & Hove Albion",1769,747,1022,"Mali",28,13,15,0,0,0,0,0,0,0,0,5,4,1,30,14,16,5,0,402,293,-1
"1172","Zechariah Medley",20,"2000","07","07","2018/2019","Defender","Arsenal",0,0,0,"England",0,0,0,0,0,0,0,0,0,0,0,0,0,0,0,0,0,0,0,-1,-1,-1
"1173","Zeze Steven Sessegnon",20,"2000","05","18","2018/2019","Defender","Fulham",0,0,0,"England",0,0,0,0,0,0,0,0,0,0,0,0,0,0,0,0,0,0,0,-1,-1,-1
"1174","Łukasz Fabiański",35,"1985","04","18","2018/2019","Goalkeeper","West Ham United",3420,1710,1710,"Poland",38,19,19,0,0,0,0,0,0,0,0,7,4,3,48,23,25,0,0,391,343,81
"1175","Aaron Anthony Connolly",21,"2000","01","28","2019/2020","Forward","Brighton & Hove Albion",1262,592,670,"Republic of Ireland",24,11,13,3,2,1,1,1,0,0,0,5,2,3,21,10,11,0,0,89,172,-1
"1176","Aaron Cresswell",31,"1989","12","15","2019/2020","Defender","West Ham United",2730,1395,1335,"England",31,16,15,3,1,2,0,0,0,0,0,5,2,3,49,25,24,7,0,151,260,129
"1177","Aaron Lennon",34,"1987","04","16","2019/2020","Midfielder","Burnley",485,225,260,"England",16,9,7,0,0,0,0,0,0,0,0,5,4,1,14,8,6,4,0,320,402,-1
"1178","Aaron Mooy",30,"1990","09","15","2019/2020","Midfielder","Brighton & Hove Albion",2090,1010,1080,"Australia",31,16,15,2,1,1,2,0,2,0,0,7,3,4,30,15,15,3,1,164,140,-1
"1179","Aaron Ramsdale",22,"1998","05","14","2019/2020","Goalkeeper","AFC Bournemouth",3330,1620,1710,"England",37,18,19,0,0,0,1,0,1,0,0,5,3,2,61,26,35,0,0,362,248,135
"1180","Aaron Wan-Bissaka",23,"1997","11","26","2019/2020","Midfielder","Manchester United",3071,1574,1497,"England",35,18,17,0,0,0,4,2,2,0,0,12,7,5,29,13,16,8,0,386,109,-1
"1181","Abdoulaye Doucouré",28,"1993","01","01","2019/2020","Midfielder","Watford",3166,1655,1511,"France",37,19,18,4,1,3,2,1,1,0,0,9,7,2,57,25,32,9,0,141,199,-1
"1182","Adalberto Peñaranda Maestre",23,"1997","05","31","2019/2020","Forward","Watford",0,0,0,"Venezuela",0,0,0,0,0,0,0,0,0,0,0,0,0,0,0,0,0,0,0,-1,-1,-1
"1183","Adam David Lallana",32,"1988","05","10","2019/2020","Midfielder","Liverpool",373,198,175,"England",15,9,6,1,0,1,1,1,0,0,0,6,4,2,5,3,2,1,0,76,33,-1
"1184","Adam Masina",27,"1994","01","02","2019/2020","Defender","Watford",1819,935,884,"Italy",26,14,12,1,1,0,0,0,0,0,0,7,5,2,27,11,16,3,0,223,289,101
"1185","Adam Smith",29,"1991","04","29","2019/2020","Defender","AFC Bournemouth",2060,1031,1029,"England",24,12,12,0,0,0,1,1,0,0,0,4,3,1,39,18,21,7,0,363,231,139
"1186","Adam Uche Idah",20,"2001","03","11","2019/2020","Forward","Norwich City",219,69,150,"Republic of Ireland",12,6,6,0,0,0,0,0,0,0,0,0,0,0,8,1,7,0,0,-1,-1,-1
"1187","Adam Webster",26,"1995","01","04","2019/2020","Defender","Brighton & Hove Albion",2670,1206,1464,"England",31,14,17,3,0,3,1,0,1,0,0,7,3,4,42,19,23,4,0,153,255,111
"1188","Adama Traoré Diarra",25,"1996","01","25","2019/2020","Midfielder","Wolverhampton Wanderers",2605,1254,1351,"Spain",37,19,18,4,2,2,9,4,5,0,0,12,8,4,30,14,16,1,0,119,20,-1
"1189","Adrian Mariappa",34,"1986","10","03","2019/2020","Defender","Watford",1509,590,919,"Jamaica",20,8,12,0,0,0,0,0,0,0,0,5,3,2,27,10,17,6,1,296,275,127
"1190","Adrián San Miguel del Castillo",34,"1987","01","03","2019/2020","Goalkeeper","Liverpool",873,513,360,"Spain",11,7,4,0,0,0,0,0,0,0,0,2,0,2,10,8,2,1,0,343,309,44
"1191","Ahmed Eissa El Mohamady Abdel Fattah",33,"1987","09","09","2019/2020","Midfielder","Aston Villa",1026,568,458,"Egypt",18,11,7,1,0,1,1,0,1,0,0,6,6,0,25,14,11,1,0,170,148,-1
"1192","Ainsley Maitland-Niles",23,"1997","08","29","2019/2020","Midfielder","Arsenal",1382,685,697,"England",20,10,10,0,0,0,2,0,2,0,0,5,1,4,20,12,8,6,1,379,98,-1
"1193","Akin Famewo",22,"1998","11","09","2019/2020","Defender","Norwich City",0,0,0,"England",1,0,1,0,0,0,0,0,0,0,0,0,0,0,0,0,0,0,0,-1,-1,-1
"1194","Albian Ajeti",24,"1997","02","26","2019/2020","Forward","West Ham United",130,78,52,"Switzerland",9,5,4,0,0,0,0,0,0,0,0,0,0,0,2,1,1,0,0,-1,-1,-1
"1195","Alex Iwobi",24,"1996","05","03","2019/2020","Forward","Everton",1604,754,850,"Nigeria",25,12,13,1,1,0,0,0,0,0,0,4,3,1,27,9,18,0,0,198,388,-1
"1196","Alex McCarthy",31,"1989","12","03","2019/2020","Goalkeeper","Southampton",2520,1260,1260,"England",28,14,14,0,0,0,0,0,0,0,0,7,3,4,33,16,17,0,0,329,354,61
"1197","Alex Oxlade-Chamberlain",27,"1993","08","15","2019/2020","Midfielder","Liverpool",1489,560,929,"England",30,13,17,4,2,2,1,0,1,0,0,12,5,7,12,3,9,1,0,74,192,-1
"1198","Alexander Banor Tettey",35,"1986","04","04","2019/2020","Midfielder","Norwich City",2351,1227,1124,"Norway",30,15,15,1,1,0,1,0,1,0,0,5,2,3,43,23,20,5,0,230,221,-1
"1199","Alexander Cochrane",0,"1970","01","01","2019/2020","Midfielder","Brighton & Hove Albion",0,0,0,"England",0,0,0,0,0,0,0,0,0,0,0,0,0,0,0,0,0,0,0,-1,-1,-1
"1200","Alexandre Jankewitz",19,"2001","12","25","2019/2020","Midfielder","Southampton",0,0,0,"Switzerland",0,0,0,0,0,0,0,0,0,0,0,0,0,0,0,0,0,0,0,-1,-1,-1
"1201","Alexandre Lacazette",29,"1991","05","28","2019/2020","Forward","Arsenal",1878,998,880,"France",30,15,15,10,8,2,4,3,1,0,0,8,4,4,24,12,12,8,0,23,62,-1
"1202","Alexandre Nascimento Costa Silva",24,"1997","03","16","2019/2020","Forward","West Ham United",0,0,0,"Portugal",0,0,0,0,0,0,0,0,0,0,0,0,0,0,0,0,0,0,0,-1,-1,-1
"1203","Alexis Mac Allister",22,"1998","12","24","2019/2020","Midfielder","Brighton & Hove Albion",351,184,167,"Argentina",9,4,5,0,0,0,0,0,0,0,0,4,1,3,6,5,1,0,0,261,314,-1
"1204","Alfie Lewis",21,"1999","09","28","2019/2020","Midfielder","West Ham United",0,0,0,"England",0,0,0,0,0,0,0,0,0,0,0,0,0,0,0,0,0,0,0,-1,-1,-1
"1205","Alfie Whiteman",22,"1998","10","02","2019/2020","Goalkeeper","Tottenham Hotspur",0,0,0,"England",0,0,0,0,0,0,0,0,0,0,0,0,0,0,0,0,0,0,0,-1,-1,-1
"1206","Ali Koiki",20,"2000","08","22","2019/2020","Defender","Burnley",0,0,0,"England",0,0,0,0,0,0,0,0,0,0,0,0,0,0,0,0,0,0,0,-1,-1,-1
"1207","Alireza Jahanbakhsh",27,"1993","08","11","2019/2020","Forward","Brighton & Hove Albion",307,177,130,"Iran",10,6,4,2,2,0,0,0,0,0,0,2,1,1,4,1,3,0,0,15,291,-1
"1208","Alisson Becker",28,"1992","10","02","2019/2020","Goalkeeper","Liverpool",2545,1195,1350,"Brazil",29,14,15,0,0,0,1,1,0,0,0,13,7,6,23,8,15,1,1,312,223,14
"1209","Allan Saint-Maximin",24,"1997","03","12","2019/2020","Midfielder","Newcastle United",1874,1028,846,"France",26,15,11,3,1,2,4,1,3,0,0,10,6,4,19,10,9,0,0,114,63,-1
"1210","André Filipe Tavares Gomes",27,"1993","07","30","2019/2020","Midfielder","Everton",1460,838,622,"Portugal",19,10,9,0,0,0,1,1,0,0,0,6,3,3,18,10,8,6,0,396,193,-1
"1211","Andre Gray",29,"1991","06","26","2019/2020","Forward","Watford",744,470,274,"England",23,9,14,2,1,1,0,0,0,0,0,5,3,2,14,10,4,1,0,75,363,-1
"1212","Andreas Christensen",25,"1996","04","10","2019/2020","Defender","Chelsea",1754,808,946,"Denmark",21,10,11,0,0,0,0,0,0,0,0,3,3,0,32,9,23,5,0,313,408,131
"1213","Andreas Pereira",25,"1996","01","01","2019/2020","Midfielder","Manchester United",1490,787,703,"Brazil",25,12,13,1,1,0,3,2,1,0,0,8,5,3,16,7,9,3,0,207,69,-1
"1214","Andrew Lonergan",37,"1983","10","19","2019/2020","Goalkeeper","Liverpool",0,0,0,"England",0,0,0,0,0,0,0,0,0,0,0,0,0,0,0,0,0,0,0,-1,-1,-1
"1215","Andrew Robertson",27,"1994","03","11","2019/2020","Defender","Liverpool",3113,1553,1560,"Scotland",36,18,18,2,1,1,12,6,6,0,0,14,7,7,31,15,16,2,0,210,14,28
"1216","Andrew Surman",34,"1986","08","20","2019/2020","Midfielder","AFC Bournemouth",233,0,233,"England",5,0,5,0,0,0,0,0,0,0,0,0,0,0,6,0,6,1,0,-1,-1,-1
"1217","Andriy Yarmolenko",31,"1989","10","23","2019/2020","Forward","West Ham United",986,566,420,"Ukraine",23,11,12,5,4,1,1,1,0,0,0,6,2,4,16,10,6,2,0,27,144,-1
"1218","Andros Townsend",29,"1991","07","16","2019/2020","Midfielder","Crystal Palace",1290,567,723,"England",24,11,13,1,1,0,1,1,0,0,0,7,4,3,22,6,16,0,0,192,186,-1
"1219","Andy Carroll",32,"1989","01","06","2019/2020","Forward","Newcastle United",618,326,292,"England",19,10,9,0,0,0,4,3,1,0,0,6,4,2,7,4,3,1,0,258,2,-1
"1220","Angel Gomes",20,"2000","08","31","2019/2020","Midfielder","Manchester United",19,10,9,"England",2,1,1,0,0,0,0,0,0,0,0,1,1,0,1,0,1,0,0,-1,-1,-1
"1221","Angelo Ogbonna",32,"1988","05","23","2019/2020","Defender","West Ham United",2787,1260,1527,"Italy",31,14,17,2,2,0,0,0,0,0,0,7,3,4,42,20,22,4,0,214,293,105
"1222","Angus Gunn",25,"1996","01","22","2019/2020","Goalkeeper","Southampton",900,450,450,"England",10,5,5,0,0,0,0,0,0,0,0,2,0,2,23,17,6,0,0,323,405,166
"1223","Anthony Driscoll-Glennon",21,"1999","11","26","2019/2020","Defender","Burnley",0,0,0,"England",0,0,0,0,0,0,0,0,0,0,0,0,0,0,0,0,0,0,0,-1,-1,-1
"1224","Anthony Gordon",20,"2001","02","24","2019/2020","Midfielder","Everton",437,273,164,"England",11,5,6,0,0,0,1,1,0,0,0,3,1,2,6,4,2,0,0,263,50,-1
"1225","Anthony Martial",25,"1995","12","05","2019/2020","Forward","Manchester United",2640,1273,1367,"France",32,16,16,17,11,6,6,5,1,0,1,12,6,6,24,13,11,1,0,16,54,-1
"1226","Antonio Rüdiger",28,"1993","03","03","2019/2020","Defender","Chelsea",1710,900,810,"Germany",20,10,10,2,0,2,0,0,0,0,0,5,4,1,23,9,14,3,0,136,270,65
"1227","Anwar El Ghazi",25,"1995","05","03","2019/2020","Forward","Aston Villa",2060,1209,851,"Netherlands",34,18,16,4,4,0,4,0,4,1,0,6,6,0,45,25,20,3,0,101,71,-1
"1228","Archie Mair",20,"2001","02","10","2019/2020","Goalkeeper","Norwich City",0,0,0,"Scotland",0,0,0,0,0,0,0,0,0,0,0,0,0,0,0,0,0,0,0,-1,-1,-1
"1229","Armando Broja",19,"2001","09","10","2019/2020","Forward","Chelsea",4,4,0,"England",1,1,0,0,0,0,0,0,0,0,0,1,1,0,0,0,0,0,0,-1,-1,-1
"1230","Arnaut Groeneveld",24,"1997","01","31","2019/2020","Forward","AFC Bournemouth",626,320,306,"Netherlands",14,7,7,0,0,0,0,0,0,0,0,2,1,1,12,7,5,0,0,269,298,-1
"1231","Arthur Masuaku",27,"1993","11","07","2019/2020","Defender","West Ham United",933,362,571,"France",17,7,10,0,0,0,1,1,0,0,0,5,2,3,17,9,8,6,1,262,132,132
"1232","Artur Boruc",41,"1980","02","20","2019/2020","Goalkeeper","AFC Bournemouth",0,0,0,"Poland",0,0,0,0,0,0,0,0,0,0,0,0,0,0,0,0,0,0,0,-1,-1,-1
"1233","Ashley Barnes",31,"1989","10","30","2019/2020","Forward","Burnley",1362,750,612,"England",19,11,8,6,3,3,0,0,0,1,0,7,5,2,21,12,9,4,0,36,413,-1
"1234","Ashley Westwood",31,"1990","04","01","2019/2020","Midfielder","Burnley",3150,1530,1620,"England",35,17,18,2,1,1,6,4,2,0,0,15,8,7,37,16,21,9,0,201,70,-1
"1235","Ashley Young",35,"1985","07","09","2019/2020","Midfielder","Manchester United",954,416,538,"England",12,5,7,0,0,0,0,0,0,0,0,2,1,1,9,3,6,5,0,389,403,-1
"1236","Axel Tuanzebe",23,"1997","11","14","2019/2020","Defender","Manchester United",186,90,96,"England",5,2,3,0,0,0,0,0,0,0,0,1,1,0,2,1,1,0,0,-1,-1,-1
"1237","Aymeric Laporte",26,"1994","05","27","2019/2020","Defender","Manchester City",1104,460,644,"France",15,7,8,1,0,1,0,0,0,0,0,11,6,5,5,2,3,1,0,175,285,1
"1238","Ayotomiwa Dele-Bashiru",21,"1999","09","17","2019/2020","Midfielder","Watford",0,0,0,"England",0,0,0,0,0,0,0,0,0,0,0,0,0,0,0,0,0,0,0,-1,-1,-1
"1239","Ayoze Perez",27,"1993","07","29","2019/2020","Forward","Leicester City",2019,922,1097,"Spain",33,16,17,8,3,5,4,0,4,1,0,12,7,5,23,10,13,0,0,45,66,-1
"1240","Bailey Peacock-Farrell",24,"1996","10","29","2019/2020","Goalkeeper","Burnley",0,0,0,"England",0,0,0,0,0,0,0,0,0,0,0,0,0,0,0,0,0,0,0,-1,-1,-1
"1241","Bakayo Sako",0,"1970","01","01","2019/2020","Midfielder","Arsenal",1755,834,921,"England",26,13,13,1,0,1,5,3,2,0,0,8,4,4,17,7,10,6,0,221,31,-1
"1242","Ben Chilwell",24,"1996","12","21","2019/2020","Defender","Leicester City",2376,1306,1070,"England",27,15,12,3,1,2,3,1,2,0,0,10,5,5,24,15,9,3,0,144,126,29
"1243","Ben Davies",28,"1993","04","24","2019/2020","Defender","Tottenham Hotspur",1432,646,786,"Wales",18,9,9,0,0,0,0,0,0,0,0,5,4,1,18,6,12,6,0,284,394,55
"1244","Ben Foster",38,"1983","04","03","2019/2020","Goalkeeper","Watford",3420,1710,1710,"England",38,19,19,0,0,0,0,0,0,0,0,9,7,2,58,25,33,1,0,398,368,123
"1245","Ben Gibson",28,"1993","01","15","2019/2020","Defender","Burnley",0,0,0,"England",0,0,0,0,0,0,0,0,0,0,0,0,0,0,0,0,0,0,0,-1,-1,-1
"1246","Ben Godfrey",23,"1998","01","15","2019/2020","Midfielder","Norwich City",2646,1336,1310,"England",30,15,15,0,0,0,0,0,0,0,0,4,2,2,59,30,29,4,1,346,332,-1
"1247","Ben Mee",31,"1989","09","21","2019/2020","Defender","Burnley",2880,1440,1440,"England",32,16,16,1,0,1,1,0,1,0,0,13,8,5,43,18,25,7,0,253,244,98
"1248","Ben Osborn",26,"1994","08","05","2019/2020","Midfielder","Sheffield United",589,403,186,"England",13,7,6,0,0,0,0,0,0,0,0,7,4,3,3,1,2,0,0,315,400,-1
"1249","Beni Baningime",32,"1988","09","09","2019/2020","Midfielder","Everton",0,0,0,"Congo DR",0,0,0,0,0,0,0,0,0,0,0,0,0,0,0,0,0,0,0,-1,-1,-1
"1250","Benjamin Johnson",21,"2000","01","24","2019/2020","Forward","West Ham United",270,180,90,"England",3,2,1,0,0,0,0,0,0,0,0,0,0,0,3,2,1,0,0,-1,-1,-1
"1251","Benjamin Mendy",26,"1994","07","17","2019/2020","Defender","Manchester City",1497,826,671,"France",19,10,9,0,0,0,2,2,0,0,0,9,5,4,10,4,6,3,0,273,117,4
"1252","Bernard Anício Caldeira Duarte",28,"1992","09","08","2019/2020","Midfielder","Everton",1280,688,592,"Brazil",27,15,12,3,3,0,2,1,1,0,0,7,5,2,11,3,8,2,0,88,94,-1
"1253","Bernard Patrick Ashley-Seal",22,"1998","11","21","2019/2020","Forward","Wolverhampton Wanderers",0,0,0,"England",0,0,0,0,0,0,0,0,0,0,0,0,0,0,0,0,0,0,0,-1,-1,-1
"1254","Bernardo",25,"1995","05","14","2019/2020","Defender","Brighton & Hove Albion",675,257,418,"Brazil",14,4,10,0,0,0,0,0,0,0,0,2,0,2,17,6,11,1,0,410,356,163
"1255","Bernardo Rusa",20,"2000","09","20","2019/2020","Midfielder","West Ham United",0,0,0,"England",0,0,0,0,0,0,0,0,0,0,0,0,0,0,0,0,0,0,0,-1,-1,-1
"1256","Bernardo Silva",26,"1994","08","10","2019/2020","Midfielder","Manchester City",2029,972,1057,"Portugal",34,17,17,6,4,2,7,3,4,0,0,16,10,6,23,8,15,5,0,62,21,-1
"1257","Bernd Leno",29,"1992","03","04","2019/2020","Goalkeeper","Arsenal",2650,1350,1300,"Germany",30,15,15,0,0,0,0,0,0,0,0,7,4,3,38,20,18,2,0,368,373,88
"1258","Billy Gilmour",19,"2001","06","11","2019/2020","Midfielder","Chelsea",191,111,80,"Scotland",6,5,1,0,0,0,0,0,0,0,0,3,3,0,3,1,2,0,0,-1,-1,-1
"1259","Billy Sharp",35,"1986","02","05","2019/2020","Forward","Sheffield United",1052,580,472,"England",25,13,12,3,2,1,2,0,2,0,0,8,5,3,10,6,4,2,1,63,72,-1
"1260","Bjorn Engels",26,"1994","09","15","2019/2020","Defender","Aston Villa",1446,787,659,"Belgium",17,9,8,1,1,0,0,0,0,0,0,2,2,0,29,14,15,1,0,217,287,149
"1261","Bobby Thomas",0,"1970","01","01","2019/2020","Defender","Burnley",0,0,0,"England",0,0,0,0,0,0,0,0,0,0,0,0,0,0,0,0,0,0,0,-1,-1,-1
"1262","Borja Bastón",28,"1992","08","25","2019/2020","Forward","Aston Villa",16,7,9,"Spain",2,1,1,0,0,0,0,0,0,0,0,0,0,0,0,0,0,0,0,-1,-1,-1
"1263","Brandon Austin",22,"1999","01","08","2019/2020","Goalkeeper","Tottenham Hotspur",0,0,0,"USA",0,0,0,0,0,0,0,0,0,0,0,0,0,0,0,0,0,0,0,-1,-1,-1
"1264","Brandon Leroy Pierrick Keutcha",19,"2001","12","10","2019/2020","Midfielder","Crystal Palace",6,0,6,"England",1,0,1,0,0,0,0,0,0,0,0,0,0,0,0,0,0,0,0,-1,-1,-1
"1265","Brandon Pierrick",19,"2001","12","10","2019/2020","Midfielder","Crystal Palace",7,0,7,"England",1,0,1,0,0,0,0,0,0,0,0,0,0,0,0,0,0,0,0,-1,-1,-1
"1266","Brandon Williams",20,"2000","09","03","2019/2020","Defender","Manchester United",1005,511,494,"England",17,8,9,1,0,1,0,0,0,0,0,7,2,5,9,6,3,6,0,169,321,13
"1267","Bruno André Cavaco Jordão",22,"1998","10","12","2019/2020","Midfielder","Wolverhampton Wanderers",6,0,6,"Portugal",1,0,1,0,0,0,0,0,0,0,0,0,0,0,0,0,0,0,0,-1,-1,-1
"1268","Bruno Miguel Borges Fernandes",26,"1994","09","08","2019/2020","Midfielder","Manchester United",1193,612,581,"Portugal",14,7,7,8,2,6,7,5,2,4,0,9,4,5,6,4,2,2,0,12,3,-1
"1269","Caglar Söyüncü",24,"1996","05","23","2019/2020","Defender","Leicester City",3037,1530,1507,"Turkey",34,17,17,1,0,1,1,0,1,0,0,12,7,5,30,15,15,5,1,249,241,26
"1270","Callum Hudson-Odoi",20,"2000","11","07","2019/2020","Midfielder","Chelsea",851,457,394,"England",22,12,10,1,1,0,5,3,2,0,0,7,7,0,13,4,9,1,0,147,4,-1
"1271","Callum Robinson",26,"1995","02","02","2019/2020","Forward","Sheffield United",676,195,481,"England",16,6,10,1,0,1,1,1,0,0,0,3,1,2,6,1,5,1,0,124,108,-1
"1272","Callum Wilson",29,"1992","02","27","2019/2020","Forward","AFC Bournemouth",2910,1527,1383,"England",35,18,17,8,4,4,1,0,1,0,0,4,3,1,51,24,27,10,0,73,247,-1
"1273","Calum Chambers",26,"1995","01","20","2019/2020","Defender","Arsenal",1103,473,630,"England",14,7,7,1,1,0,1,1,0,0,0,3,1,2,15,8,7,5,0,178,159,66
"1274","Caoimhin Kelleher",22,"1998","11","23","2019/2020","Goalkeeper","Liverpool",0,0,0,"Republic of Ireland",0,0,0,0,0,0,0,0,0,0,0,0,0,0,0,0,0,0,0,-1,-1,-1
"1275","Carlos Sánchez",35,"1986","02","06","2019/2020","Midfielder","West Ham United",113,93,20,"Colombia",6,3,3,0,0,0,0,0,0,0,0,2,1,1,2,2,0,0,0,-1,-1,-1
"1276","Cedric Soares",29,"1991","08","31","2019/2020","Defender","Arsenal",1560,838,722,"Portugal",21,11,10,1,1,0,1,1,0,0,0,6,2,4,18,12,6,1,0,206,206,45
"1277","Cenk Tosun",29,"1991","06","07","2019/2020","Forward","Crystal Palace",466,308,158,"Turkey",10,7,3,2,1,1,0,0,0,0,0,3,2,1,5,4,1,0,0,39,370,-1
"1278","Cesar Azpilicueta",31,"1989","08","28","2019/2020","Defender","Chelsea",3230,1530,1700,"Spain",36,17,19,2,1,1,6,3,3,0,0,8,7,1,52,15,37,1,0,202,74,116
"1279","Charlie Daniels",34,"1986","09","07","2019/2020","Defender","AFC Bournemouth",127,37,90,"England",2,1,1,0,0,0,0,0,0,0,0,0,0,0,2,1,1,0,0,-1,-1,-1
"1280","Charlie Taylor",27,"1993","09","18","2019/2020","Defender","Burnley",1945,911,1034,"England",24,12,12,0,0,0,1,0,1,0,0,11,5,6,17,6,11,3,0,274,215,10
"1281","Che Adams",24,"1996","07","13","2019/2020","Midfielder","Southampton",1105,556,549,"England",30,15,15,4,3,1,2,1,1,0,0,8,2,6,16,9,7,0,0,48,83,-1
"1282","Cheikhou Kouyaté",31,"1989","12","21","2019/2020","Midfielder","Crystal Palace",2536,1293,1243,"Senegal",35,17,18,1,1,0,1,1,0,0,0,9,5,4,34,13,21,4,0,232,235,-1
"1283","Chris Basham",32,"1988","07","20","2019/2020","Defender","Sheffield United",3255,1629,1626,"England",38,19,19,0,0,0,1,1,0,0,0,13,8,5,36,14,22,4,0,339,246,41
"1284","Chris Mepham",23,"1997","11","05","2019/2020","Defender","AFC Bournemouth",910,460,450,"Wales",12,7,5,1,1,0,0,0,0,0,0,1,0,1,19,9,10,1,0,161,393,155
"1285","Chris Wood",29,"1991","12","07","2019/2020","Forward","Burnley",2446,1335,1111,"New Zealand",32,16,16,14,9,5,1,0,1,1,0,12,6,6,31,16,15,1,0,18,224,-1
"1286","Christain Saydee",18,"2002","05","10","2019/2020","Forward","AFC Bournemouth",0,0,0,"England",0,0,0,0,0,0,0,0,0,0,0,0,0,0,0,0,0,0,0,-1,-1,-1
"1287","Christian Atsu Twasam",29,"1992","01","10","2019/2020","Midfielder","Newcastle United",739,205,534,"Ghana",19,7,12,0,0,0,3,1,2,0,0,4,2,2,12,2,10,2,0,288,12,-1
"1288","Christian Benteke",30,"1990","12","03","2019/2020","Forward","Crystal Palace",1257,584,673,"Belgium",24,11,13,2,1,1,1,0,1,0,0,8,4,4,17,7,10,5,1,116,189,-1
"1289","Christian Eriksen",29,"1992","02","14","2019/2020","Midfielder","Tottenham Hotspur",1091,397,694,"Denmark",20,8,12,2,0,2,2,1,1,0,0,2,1,1,16,3,13,5,0,106,80,-1
"1290","Christian Fuchs",35,"1986","04","07","2019/2020","Defender","Leicester City",770,199,571,"Austria",11,4,7,0,0,0,0,0,0,0,0,3,2,1,10,1,9,0,0,282,397,59
"1291","Christian Kabasele",30,"1991","02","24","2019/2020","Defender","Watford",2252,1241,1011,"Belgium",27,14,13,0,0,0,2,2,0,0,0,7,6,1,30,13,17,4,2,404,157,64
"1292","Christian Pulisic",22,"1998","09","18","2019/2020","Midfielder","Chelsea",1727,870,857,"USA",25,12,13,9,2,7,4,1,3,0,0,5,5,0,28,7,21,0,0,25,49,-1
"1293","Christoph Zimmermann",28,"1993","01","12","2019/2020","Defender","Norwich City",1430,674,756,"Germany",17,8,9,0,0,0,1,1,0,0,0,3,1,2,26,11,15,3,0,290,191,133
"1294","Ciaran Clark",31,"1989","09","26","2019/2020","Defender","Newcastle United",1189,586,603,"Republic of Ireland",14,7,7,2,1,1,0,0,0,0,0,4,3,1,13,4,9,3,0,110,371,36
"1295","Claudio Andrés Bravo Muñoz",38,"1983","04","13","2019/2020","Goalkeeper","Manchester City",346,180,166,"Chile",4,2,2,0,0,0,0,0,0,0,0,1,1,0,7,1,6,0,0,360,337,150
"1296","Cole Palmer",19,"2002","05","06","2019/2020","Defender","Manchester City",0,0,0,"England",0,0,0,0,0,0,0,0,0,0,0,0,0,0,0,0,0,0,0,-1,-1,-1
"1297","Connor Wickham",28,"1993","03","31","2019/2020","Forward","Crystal Palace",90,43,47,"England",6,3,3,1,0,1,1,1,0,0,0,1,1,0,2,0,2,0,0,-1,-1,-1
"1298","Conor Coady",28,"1993","02","25","2019/2020","Midfielder","Wolverhampton Wanderers",3420,1710,1710,"England",38,19,19,0,0,0,0,0,0,0,0,13,8,5,35,16,19,5,0,373,412,-1
"1299","Conor Coventry",21,"2000","03","25","2019/2020","Midfielder","West Ham United",0,0,0,"Republic of Ireland",0,0,0,0,0,0,0,0,0,0,0,0,0,0,0,0,0,0,0,-1,-1,-1
"1300","Conor Hourihane",30,"1991","02","02","2019/2020","Midfielder","Aston Villa",1539,826,713,"Republic of Ireland",27,13,14,3,2,1,5,2,3,0,0,5,5,0,27,14,13,4,0,98,25,-1
"1301","Craig Cathcart",32,"1989","02","06","2019/2020","Defender","Watford",2489,1185,1304,"Northern Ireland",29,14,15,0,0,0,0,0,0,0,0,9,7,2,33,16,17,7,0,400,367,62
"1302","Craig Dawson",30,"1990","05","06","2019/2020","Defender","Watford",2359,1188,1171,"England",29,15,14,2,2,0,0,0,0,0,0,6,4,2,46,20,26,6,0,179,365,142
"1303","Curtis Jones",20,"2001","01","30","2019/2020","Midfielder","Liverpool",122,98,24,"England",6,3,3,1,1,0,0,0,0,0,0,3,1,2,1,1,0,0,0,-1,-1,-1
"1304","Dale Stephens",31,"1989","06","12","2019/2020","Midfielder","Brighton & Hove Albion",2529,1185,1344,"England",33,16,17,0,0,0,1,1,0,0,0,9,4,5,40,16,24,8,0,407,227,-1
"1305","Damián Emiliano Martínez",28,"1992","09","02","2019/2020","Goalkeeper","Arsenal",770,360,410,"Argentina",9,4,5,0,0,0,0,0,0,0,0,3,1,2,8,4,4,2,0,383,345,34
"1306","Dan Burn",28,"1992","05","09","2019/2020","Defender","Brighton & Hove Albion",2881,1441,1440,"England",34,18,16,0,0,0,0,0,0,0,0,9,4,5,39,20,19,5,0,406,348,68
"1307","Dan Gosling",31,"1990","02","01","2019/2020","Midfielder","AFC Bournemouth",1261,517,744,"England",24,12,12,3,2,1,1,1,0,0,0,2,1,1,22,7,15,3,0,90,174,-1
"1308","Dan Nlundulu",22,"1999","02","05","2019/2020","Forward","Southampton",0,0,0,"England",0,0,0,0,0,0,0,0,0,0,0,0,0,0,0,0,0,0,0,-1,-1,-1
"1309","Dani Ceballos",24,"1996","08","07","2019/2020","Midfielder","Arsenal",1698,960,738,"Spain",24,13,11,0,0,0,2,2,0,0,0,7,4,3,20,10,10,1,0,382,120,-1
"1310","Daniel Adshead",19,"2001","09","02","2019/2020","Midfielder","Norwich City",0,0,0,"Ecuador",0,0,0,0,0,0,0,0,0,0,0,0,0,0,0,0,0,0,0,-1,-1,-1
"1311","Daniel Castelo Podence",25,"1995","10","21","2019/2020","Forward","Wolverhampton Wanderers",285,170,115,"Portugal",9,5,4,1,1,0,0,0,0,0,0,6,5,1,0,0,0,0,0,49,310,-1
"1312","Daniel James",23,"1997","11","10","2019/2020","Midfielder","Manchester United",2291,1131,1160,"Wales",33,17,16,3,2,1,6,2,4,0,0,11,7,4,25,10,15,4,0,132,40,-1
"1313","Daniel William John Ings",28,"1992","07","23","2019/2020","Forward","Southampton",2815,1459,1356,"England",38,19,19,22,10,12,2,0,2,1,1,9,3,6,42,26,16,3,0,3,202,-1
"1314","Danny Drinkwater",31,"1990","03","05","2019/2020","Midfielder","Aston Villa",322,254,68,"England",5,4,1,0,0,0,0,0,0,0,0,0,0,0,11,10,1,1,0,298,294,-1
"1315","Danny Rose",30,"1990","07","02","2019/2020","Defender","Newcastle United",1759,874,885,"England",23,12,11,0,0,0,0,0,0,0,0,6,4,2,24,8,16,7,0,412,415,71
"1316","Danny Ward",27,"1993","06","22","2019/2020","Goalkeeper","Leicester City",0,0,0,"Wales",0,0,0,0,0,0,0,0,0,0,0,0,0,0,0,0,0,0,0,-1,-1,-1
"1317","Danny Welbeck",30,"1990","11","26","2019/2020","Forward","Watford",816,367,449,"England",18,8,10,2,1,1,0,0,0,0,0,1,1,0,12,3,9,0,0,78,381,-1
"1318","Darnell Johnson",22,"1998","09","03","2019/2020","Defender","Leicester City",0,0,0,"England",0,0,0,0,0,0,0,0,0,0,0,0,0,0,0,0,0,0,0,-1,-1,-1
"1319","Darren Randolph",33,"1987","05","12","2019/2020","Goalkeeper","West Ham United",180,90,90,"Republic of Ireland",2,1,1,0,0,0,0,0,0,0,0,0,0,0,5,1,4,0,0,-1,-1,-1
"1320","Daryl Janmaat",31,"1989","07","22","2019/2020","Defender","Watford",608,267,341,"Netherlands",8,4,4,0,0,0,1,0,1,0,0,3,2,1,5,2,3,1,0,403,86,8
"1321","David Brooks",23,"1997","07","08","2019/2020","Forward","AFC Bournemouth",513,316,197,"England",9,5,4,1,0,1,0,0,0,0,0,1,1,0,12,7,5,1,0,100,315,-1
"1322","David Button",32,"1989","02","27","2019/2020","Goalkeeper","Brighton & Hove Albion",0,0,0,"England",0,0,0,0,0,0,0,0,0,0,0,0,0,0,0,0,0,0,0,-1,-1,-1
"1323","David de Gea",30,"1990","11","07","2019/2020","Goalkeeper","Manchester United",3420,1710,1710,"Spain",38,19,19,0,0,0,0,0,0,0,0,13,7,6,32,15,17,2,0,384,347,18
"1324","David Luiz",34,"1987","04","22","2019/2020","Defender","Arsenal",2852,1620,1232,"Brazil",33,18,15,2,2,0,1,1,0,0,0,8,5,3,39,21,18,7,2,204,237,69
"1325","David Martin",35,"1986","01","22","2019/2020","Goalkeeper","West Ham United",435,90,345,"England",5,1,4,0,0,0,0,0,0,0,0,2,0,2,6,3,3,1,0,268,323,73
"1326","David McGoldrick",33,"1987","11","29","2019/2020","Forward","Sheffield United",1825,1000,825,"Republic of Ireland",28,15,13,2,2,0,2,1,1,0,0,9,7,2,18,6,12,2,0,160,131,-1
"1327","David Silva",35,"1986","01","08","2019/2020","Midfielder","Manchester City",1833,1122,711,"Spain",27,16,11,6,5,1,10,5,5,0,0,11,8,3,14,6,8,0,0,54,5,-1
"1328","Davinson Sánchez Mina",24,"1996","06","12","2019/2020","Defender","Tottenham Hotspur",2430,1306,1124,"Colombia",29,15,14,0,0,0,0,0,0,0,0,4,4,0,34,14,20,6,0,413,383,77
"1329","Davy Pröpper",29,"1991","09","02","2019/2020","Midfielder","Brighton & Hove Albion",2830,1453,1377,"Netherlands",35,18,17,1,1,0,2,0,2,0,0,8,3,5,43,22,21,4,0,248,205,-1
"1330","Dean Henderson",24,"1997","03","12","2019/2020","Goalkeeper","Sheffield United",3240,1620,1620,"England",36,18,18,0,0,0,0,0,0,0,0,13,8,5,32,11,21,2,0,353,387,25
"1331","DeAndre Yedlin",27,"1993","07","09","2019/2020","Defender","Newcastle United",934,514,420,"USA",16,9,7,1,1,0,0,0,0,0,0,4,4,0,14,6,8,3,0,158,320,104
"1332","Declan Rice",22,"1999","01","14","2019/2020","Midfielder","West Ham United",3420,1710,1710,"Republic of Ireland",38,19,19,1,1,0,3,2,1,0,0,7,3,4,59,32,27,6,0,251,158,-1
"1333","Dejan Lovren",31,"1989","07","05","2019/2020","Defender","Liverpool",777,450,327,"Croatia",10,5,5,0,0,0,1,1,0,0,0,2,0,2,11,6,5,1,0,259,116,83
"1334","Dele Alli",25,"1996","04","11","2019/2020","Midfielder","Tottenham Hotspur",1853,916,937,"England",25,11,14,8,5,3,4,3,1,1,0,4,3,1,24,10,14,2,0,38,57,-1
"1335","Demarai Gray",24,"1996","06","28","2019/2020","Midfielder","Leicester City",607,271,336,"England",21,10,11,2,1,1,3,0,3,0,1,8,4,4,4,1,3,1,0,52,7,-1
"1336","Dennis Cirkin",19,"2002","04","06","2019/2020","Midfielder","Tottenham Hotspur",0,0,0,"England",0,0,0,0,0,0,0,0,0,0,0,0,0,0,0,0,0,0,0,-1,-1,-1
"1337","Dennis Praet",26,"1994","05","14","2019/2020","Midfielder","Leicester City",1131,588,543,"Belgium",27,13,14,1,1,0,2,0,2,0,0,8,5,3,16,5,11,2,0,173,84,-1
"1338","Dennis Srbeny",26,"1994","05","05","2019/2020","Forward","Norwich City",39,33,6,"Germany",8,5,3,1,0,1,0,0,0,0,0,2,0,2,1,1,0,0,0,-1,-1,-1
"1339","Diego Rico",28,"1993","02","23","2019/2020","Defender","AFC Bournemouth",2336,1170,1166,"Spain",27,13,14,0,0,0,4,2,2,0,0,5,3,2,37,14,23,6,0,364,88,113
"1340","Dimitri Foulquier",28,"1993","03","23","2019/2020","Defender","Watford",58,17,41,"France",3,1,2,0,0,0,0,0,0,0,0,1,1,0,6,0,6,0,0,-1,-1,-1
"1341","Diogo José Teixeira da Silva",24,"1996","12","04","2019/2020","Midfielder","Wolverhampton Wanderers",2298,1086,1212,"Portugal",34,17,17,7,3,4,1,0,1,0,0,11,7,4,25,12,13,4,0,61,222,-1
"1342","Divock Origi",26,"1995","04","18","2019/2020","Forward","Liverpool",704,299,405,"Belgium",28,13,15,4,3,1,1,1,0,0,0,11,5,6,12,6,6,1,0,19,95,-1
"1343","Djibril Sidibé",28,"1992","07","29","2019/2020","Defender","Everton",1820,898,922,"France",25,12,13,0,0,0,4,2,2,0,0,5,4,1,26,6,20,3,0,307,52,87
"1344","Domingos Quina",21,"1999","11","18","2019/2020","Midfielder","Watford",18,4,14,"Portugal",4,1,3,0,0,0,0,0,0,0,0,1,0,1,0,0,0,0,0,-1,-1,-1
"1345","Dominic Calvert-Lewin",24,"1997","03","16","2019/2020","Forward","Everton",2630,1195,1435,"England",36,17,19,13,7,6,1,1,0,0,0,8,5,3,38,10,28,9,0,28,253,-1
"1346","Dominic Solanke",23,"1997","09","14","2019/2020","Forward","AFC Bournemouth",1643,773,870,"England",32,13,19,3,2,1,1,1,0,0,0,3,1,2,37,15,22,1,0,103,218,-1
"1347","Douglas Luiz",22,"1998","05","09","2019/2020","Midfielder","Aston Villa",2608,1359,1249,"Brazil",36,18,18,3,2,1,2,0,2,0,0,7,7,0,48,22,26,8,0,163,176,-1
"1348","Dwight Gayle",30,"1990","10","17","2019/2020","Forward","Newcastle United",848,372,476,"England",20,9,11,4,2,2,2,1,1,0,0,4,2,2,14,8,6,2,0,30,48,-1
"1349","Dwight McNeil",21,"1999","11","22","2019/2020","Forward","Burnley",3345,1678,1667,"England",38,19,19,2,2,0,6,4,2,0,0,15,8,7,47,21,26,5,0,219,79,-1
"1350","Ederson",27,"1993","08","17","2019/2020","Goalkeeper","Manchester City",3072,1530,1542,"Brazil",35,17,18,0,0,0,0,0,0,0,0,16,9,7,24,10,14,4,1,357,278,6
"1351","Edward Nketiah",21,"1999","05","30","2019/2020","Forward","Arsenal",648,316,332,"England",13,7,6,2,1,1,0,0,0,0,0,6,3,3,8,5,3,1,1,56,316,-1
"1352","Ellis Simms",20,"2001","01","05","2019/2020","Midfielder","Everton",0,0,0,"England",0,0,0,0,0,0,0,0,0,0,0,0,0,0,0,0,0,0,0,-1,-1,-1
"1353","Emerson Palmieri dos Santos",26,"1994","08","03","2019/2020","Defender","Chelsea",1025,645,380,"Italy",15,8,7,0,0,0,0,0,0,0,0,1,1,0,20,10,10,3,0,367,407,144
"1354","Emil Krafth",26,"1994","08","02","2019/2020","Defender","Newcastle United",1018,374,644,"Sweden",17,6,11,0,0,0,1,1,0,0,0,5,2,3,20,6,14,0,0,378,141,145
"1355","Emile Smith Rowe",20,"2000","07","28","2019/2020","Midfielder","Arsenal",97,31,66,"England",2,1,1,0,0,0,0,0,0,0,0,1,0,1,0,0,0,0,0,-1,-1,-1
"1356","Emiliano Buendía",24,"1996","12","25","2019/2020","Midfielder","Norwich City",2465,1353,1112,"Argentina",36,19,17,1,0,1,7,5,2,0,0,5,2,3,50,28,22,7,1,227,32,-1
"1357","Enda Stevens",30,"1990","07","09","2019/2020","Defender","Sheffield United",3347,1637,1710,"Republic of Ireland",38,19,19,2,1,1,4,2,2,0,0,13,8,5,38,14,24,7,0,222,125,43
"1358","Eric Bertrand Bailly",27,"1994","04","12","2019/2020","Defender","Manchester United",147,56,91,"Côte d'Ivoire",4,2,2,0,0,0,0,0,0,0,0,2,1,1,1,1,0,0,0,-1,-1,-1
"1359","Eric Dier",27,"1994","01","15","2019/2020","Midfielder","Tottenham Hotspur",1342,742,600,"England",19,12,7,0,0,0,2,0,2,0,0,4,4,0,21,9,12,5,0,416,99,-1
"1360","Eric García Martret",20,"2001","01","09","2019/2020","Defender","Manchester City",790,477,313,"Spain",13,7,6,0,0,0,0,0,0,0,0,8,5,3,7,2,5,1,0,277,274,11
"1361","Erik Lamela",29,"1992","03","04","2019/2020","Midfielder","Tottenham Hotspur",1210,518,692,"Argentina",25,13,12,2,1,1,1,0,1,0,0,7,5,2,12,2,10,3,0,112,170,-1
"1362","Erik Pieters",32,"1988","08","07","2019/2020","Defender","Burnley",1879,928,951,"Netherlands",24,12,12,0,0,0,4,3,1,0,0,8,5,3,34,17,17,2,0,317,58,130
"1363","Etienne Capoue",32,"1988","07","11","2019/2020","Midfielder","Watford",2632,1321,1311,"France",30,15,15,0,0,0,3,2,1,0,0,7,5,2,44,19,25,8,0,402,137,-1
"1364","Ezri Konsa Ngoyo",23,"1998","04","06","2019/2020","Midfielder","Aston Villa",2043,1036,1007,"England",25,12,13,1,0,1,2,2,0,0,0,5,5,0,38,18,20,3,0,235,145,-1
"1365","Fabián Cornelio Balbuena González",29,"1991","08","23","2019/2020","Defender","West Ham United",1173,540,633,"Paraguay",17,8,9,1,1,0,0,0,0,0,0,5,1,4,22,13,9,2,0,181,262,138
"1366","Fabian Delph",31,"1989","11","21","2019/2020","Midfielder","Everton",1190,630,560,"England",16,8,8,0,0,0,0,0,0,0,0,3,3,0,21,8,13,5,1,299,295,-1
"1367","Fabian Schär",29,"1991","12","20","2019/2020","Defender","Newcastle United",1671,764,907,"Switzerland",22,10,12,2,2,0,0,0,0,0,0,5,4,1,33,10,23,5,0,149,364,146
"1368","Fabinho",27,"1993","10","23","2019/2020","Midfielder","Liverpool",2074,1148,926,"Brazil",28,14,14,2,2,0,3,3,0,0,0,9,4,5,26,13,13,6,0,171,101,-1
"1369","Faustino Anjorin",19,"2001","11","23","2019/2020","Defender","Chelsea",19,19,0,"England",1,1,0,0,0,0,0,0,0,0,0,1,1,0,0,0,0,0,0,-1,-1,-1
"1370","Faustino Marcos Alberto Rojo",31,"1990","03","20","2019/2020","Defender","Manchester United",120,90,30,"Argentina",3,2,1,0,0,0,0,0,0,0,0,0,0,0,2,1,1,1,0,-1,-1,-1
"1371","Federico Fernández",32,"1989","02","21","2019/2020","Defender","Newcastle United",2618,1355,1263,"Argentina",32,16,16,2,1,1,2,1,1,0,0,9,5,4,38,18,20,8,0,190,183,91
"1372","Felipe Anderson Pereira Gomes",28,"1993","04","15","2019/2020","Midfielder","West Ham United",1506,814,692,"Brazil",25,13,12,1,1,0,4,2,2,0,0,5,3,2,26,14,12,1,0,208,38,-1
"1373","Fernando Luiz Rosa",35,"1985","05","04","2019/2020","Midfielder","Manchester City",2398,1165,1233,"Brazil",30,15,15,0,0,0,1,1,0,0,0,12,7,5,23,9,14,10,2,280,220,-1
"1374","Fikayo Tomori",23,"1997","12","19","2019/2020","Defender","Chelsea",1293,630,663,"England",15,7,8,1,0,1,0,0,0,0,0,4,3,1,18,7,11,3,0,197,419,75
"1375","Filip Benković",23,"1997","07","13","2019/2020","Defender","Leicester City",0,0,0,"Croatia",0,0,0,0,0,0,0,0,0,0,0,0,0,0,0,0,0,0,0,-1,-1,-1
"1376","Florian Lejeune",29,"1991","05","20","2019/2020","Defender","Newcastle United",441,254,187,"France",6,3,3,2,0,2,0,0,0,0,0,1,1,0,10,5,5,0,0,32,335,162
"1377","Florin Andone",28,"1993","04","11","2019/2020","Forward","Brighton & Hove Albion",72,46,26,"Romania",3,2,1,1,0,1,0,0,0,0,0,1,0,1,0,0,0,1,1,-1,-1,-1
"1378","Francisco Femenía Far",30,"1991","02","02","2019/2020","Midfielder","Watford",2241,1221,1020,"Spain",28,15,13,0,0,0,0,0,0,0,0,4,4,0,44,19,25,5,0,401,366,-1
"1379","Fraser Forster",33,"1988","03","17","2019/2020","Goalkeeper","Southampton",0,0,0,"England",0,0,0,0,0,0,0,0,0,0,0,0,0,0,0,0,0,0,0,-1,-1,-1
"1380","Frédéric Guilbert",26,"1994","12","24","2019/2020","Defender","Aston Villa",2041,861,1180,"France",25,11,14,0,0,0,2,2,0,0,0,4,4,0,34,9,25,7,0,281,152,119
"1381","Frederico Rodrigues Santos",28,"1993","03","05","2019/2020","Midfielder","Manchester United",2159,1068,1091,"Brazil",29,15,14,0,0,0,0,0,0,0,0,8,5,3,23,9,14,8,0,305,263,-1
"1382","Gabriel Jesus",24,"1997","04","03","2019/2020","Forward","Manchester City",2026,987,1039,"Brazil",34,17,17,14,6,8,7,2,5,0,1,15,8,7,10,5,5,3,0,10,19,-1
"1383","Gabriel Teodoro Martinelli Silva",19,"2001","06","18","2019/2020","Midfielder","Arsenal",656,257,399,"Brazil",14,6,8,3,1,2,0,0,0,0,0,4,1,3,9,6,3,1,0,34,343,-1
"1384","Gaëtan Bong Songo",33,"1988","04","25","2019/2020","Defender","Brighton & Hove Albion",55,2,53,"Cameroon",4,2,2,0,0,0,0,0,0,0,0,2,1,1,2,0,2,0,0,-1,-1,-1
"1385","Gary Cahill",35,"1985","12","19","2019/2020","Defender","Crystal Palace",2168,1088,1080,"England",25,13,12,0,0,0,1,0,1,0,0,7,4,3,33,12,21,1,0,336,234,106
"1386","Gavin Kilkenny",21,"2000","02","01","2019/2020","Midfielder","AFC Bournemouth",0,0,0,"Republic of Ireland",0,0,0,0,0,0,0,0,0,0,0,0,0,0,0,0,0,0,0,-1,-1,-1
"1387","Gedson Carvalho Fernandes",22,"1999","01","09","2019/2020","Midfielder","Tottenham Hotspur",61,44,17,"Portugal",7,4,3,0,0,0,0,0,0,0,0,3,1,2,1,1,0,0,0,-1,-1,-1
"1388","George Baldock",28,"1993","03","09","2019/2020","Defender","Sheffield United",3420,1710,1710,"England",38,19,19,2,0,2,3,1,2,0,0,13,8,5,38,14,24,7,0,218,155,39
"1389","George Hirst",22,"1999","02","15","2019/2020","Forward","Leicester City",9,2,7,"England",2,1,1,0,0,0,0,0,0,0,0,0,0,0,0,0,0,0,0,-1,-1,-1
"1390","Georges-Kevin N'Koudou Mbida",26,"1995","02","13","2019/2020","Forward","Tottenham Hotspur",2,2,0,"France",1,1,0,0,0,0,0,0,0,0,0,0,0,0,0,0,0,0,0,-1,-1,-1
"1391","Georginio Wijnaldum",30,"1990","11","11","2019/2020","Midfielder","Liverpool",2948,1520,1428,"Netherlands",37,19,18,4,3,1,0,0,0,0,0,14,7,7,28,13,15,0,0,134,311,-1
"1392","Gerard Deulofeu",27,"1994","03","13","2019/2020","Forward","Watford",2109,1063,1046,"Spain",28,14,14,4,2,2,5,3,2,1,0,9,7,2,32,14,18,3,0,102,45,-1
"1393","Giovani Lo Celso",25,"1996","04","09","2019/2020","Midfielder","Tottenham Hotspur",1487,806,681,"Argentina",28,13,15,0,0,0,2,0,2,0,0,6,4,2,16,7,9,6,0,293,110,-1
"1394","Giovanni McGregor",0,"1970","01","01","2019/2020","Midfielder","Crystal Palace",0,0,0,"England",0,0,0,0,0,0,0,0,0,0,0,0,0,0,0,0,0,0,0,-1,-1,-1
"1395","Glenn Murray",37,"1983","09","25","2019/2020","Forward","Brighton & Hove Albion",786,394,392,"England",23,13,10,1,0,1,1,0,1,0,0,5,3,2,9,3,6,0,0,148,123,-1
"1396","Gonçalo Bento Soares Cardoso",20,"2000","10","21","2019/2020","Defender","West Ham United",0,0,0,"Portugal",0,0,0,0,0,0,0,0,0,0,0,0,0,0,0,0,0,0,0,-1,-1,-1
"1397","Granit Xhaka",28,"1992","09","27","2019/2020","Midfielder","Arsenal",2590,1213,1377,"Switzerland",31,14,17,1,1,0,2,1,1,0,0,10,5,5,31,15,16,10,0,241,179,-1
"1398","Grant Hanley",29,"1991","11","20","2019/2020","Defender","Norwich City",1262,642,620,"Scotland",15,8,7,0,0,0,0,0,0,0,0,3,2,1,24,9,15,4,0,345,328,140
"1399","Gylfi Sigurdsson",31,"1989","09","08","2019/2020","Midfielder","Everton",2562,1270,1292,"Iceland",35,18,17,2,2,0,3,1,2,1,0,9,6,3,41,15,26,3,0,196,122,-1
"1400","Hamza Choudhury",23,"1997","10","01","2019/2020","Midfielder","Leicester City",889,405,484,"England",20,11,9,1,0,1,1,1,0,0,0,7,5,2,10,6,4,4,1,157,134,-1
"1401","Harry Kane",27,"1993","07","28","2019/2020","Forward","Tottenham Hotspur",2590,1345,1245,"England",29,15,14,18,9,9,2,2,0,2,0,6,5,1,34,11,23,4,0,8,169,-1
"1402","Harry Lewis",23,"1997","12","20","2019/2020","Goalkeeper","Southampton",0,0,0,"England",0,0,0,0,0,0,0,0,0,0,0,0,0,0,0,0,0,0,0,-1,-1,-1
"1403","Harry Maguire",28,"1993","03","05","2019/2020","Defender","Manchester United",3420,1710,1710,"England",38,19,19,1,0,1,1,1,0,0,0,13,7,6,32,15,17,6,0,245,238,20
"1404","Harry Wilson",24,"1997","03","22","2019/2020","Midfielder","AFC Bournemouth",1653,808,845,"Wales",31,14,17,7,2,5,0,0,0,0,0,4,3,1,31,14,17,2,0,40,389,-1
"1405","Harry Winks",25,"1996","02","02","2019/2020","Midfielder","Tottenham Hotspur",2226,1183,1043,"England",31,17,14,0,0,0,0,0,0,0,0,7,5,2,29,12,17,9,0,415,392,-1
"1406","Harvey Elliot",0,"1970","01","01","2019/2020","Forward","Liverpool",6,6,0,"England",2,2,0,0,0,0,0,0,0,0,0,2,2,0,0,0,0,0,0,-1,-1,-1
"1407","Harvey Lewis Barnes",23,"1997","12","09","2019/2020","Midfielder","Leicester City",2091,1151,940,"England",36,19,17,6,4,2,8,6,2,0,0,12,8,4,23,10,13,0,0,68,15,-1
"1408","Harvey White",19,"2001","09","19","2019/2020","Midfielder","Tottenham Hotspur",0,0,0,"England",0,0,0,0,0,0,0,0,0,0,0,0,0,0,0,0,0,0,0,-1,-1,-1
"1409","Hector Bellerin",26,"1995","03","19","2019/2020","Defender","Arsenal",1159,521,638,"Spain",15,7,8,1,0,1,0,0,0,0,0,6,3,3,16,7,9,2,0,176,327,72
"1410","Henri Lansbury",30,"1990","10","12","2019/2020","Midfielder","Aston Villa",188,11,177,"England",10,4,6,0,0,0,0,0,0,0,0,3,3,0,6,1,5,0,0,-1,-1,-1
"1411","Henrikh Mkhitaryan",32,"1989","01","21","2019/2020","Midfielder","Arsenal",111,23,88,"Armenia",3,1,2,0,0,0,0,0,0,0,0,1,0,1,0,0,0,1,0,-1,-1,-1
"1412","Heung-Min Son",28,"1992","07","08","2019/2020","Forward","Tottenham Hotspur",2485,1321,1164,"South Korea",30,16,14,11,7,4,10,6,4,0,1,8,6,2,30,10,20,2,2,37,13,-1
"1413","Heurelho da Silva Gomes",40,"1981","02","15","2019/2020","Goalkeeper","Watford",0,0,0,"Brazil",0,0,0,0,0,0,0,0,0,0,0,0,0,0,0,0,0,0,0,-1,-1,-1
"1414","Hugo Lloris",34,"1986","12","26","2019/2020","Goalkeeper","Tottenham Hotspur",1808,990,818,"France",21,11,10,0,0,0,0,0,0,0,0,6,5,1,21,6,15,0,0,411,410,47
"1415","Ibrahim Amadou",28,"1993","04","06","2019/2020","Midfielder","Norwich City",757,360,397,"Cameroon",11,4,7,0,0,0,0,0,0,0,0,2,0,2,19,12,7,1,0,292,288,-1
"1416","Ignacio Pussetto",25,"1995","12","21","2019/2020","Midfielder","Watford",67,28,39,"Argentina",7,4,3,0,0,0,0,0,0,0,0,2,2,0,1,1,0,1,0,-1,-1,-1
"1417","İlkay Gündoğan",30,"1990","10","24","2019/2020","Midfielder","Manchester City",2015,1057,958,"Germany",31,17,14,2,2,0,1,1,0,1,1,12,8,4,24,7,17,7,0,172,232,-1
"1418","Indiana Vassilev",20,"2001","02","16","2019/2020","Midfielder","Aston Villa",47,19,28,"USA",4,2,2,0,0,0,0,0,0,0,0,0,0,0,1,0,1,0,0,-1,-1,-1
"1419","Isaac Ajayi Success",25,"1996","01","07","2019/2020","Forward","Watford",65,33,32,"Nigeria",5,3,2,0,0,0,0,0,0,0,0,1,1,0,1,1,0,1,0,-1,-1,-1
"1420","Isaac Hayden",26,"1995","03","22","2019/2020","Midfielder","Newcastle United",2226,1260,966,"England",29,16,13,1,1,0,2,2,0,0,0,9,6,3,28,14,14,5,1,225,156,-1
"1421","Ismaïla Sarr",23,"1998","02","25","2019/2020","Midfielder","Watford",2030,1066,964,"Senegal",28,15,13,5,4,1,4,2,2,0,0,7,6,1,32,12,20,1,0,81,68,-1
"1422","Issa Diop",24,"1997","01","09","2019/2020","Defender","West Ham United",2766,1504,1262,"France",32,17,15,3,2,1,1,0,1,0,0,5,2,3,52,29,23,8,0,156,250,137
"1423","Jack Cork",31,"1989","06","25","2019/2020","Midfielder","Burnley",2618,1346,1272,"England",30,15,15,0,0,0,0,0,0,0,0,12,7,5,40,18,22,1,0,319,414,-1
"1424","Jack Grealish",25,"1995","09","10","2019/2020","Midfielder","Aston Villa",3234,1620,1614,"England",36,18,18,8,3,5,6,5,1,0,1,7,7,0,60,27,33,8,0,84,75,-1
"1425","Jack O'Connell",27,"1994","03","29","2019/2020","Defender","Sheffield United",2915,1620,1295,"England",33,18,15,0,0,0,1,1,0,0,0,12,8,4,28,14,14,4,0,326,245,22
"1426","Jack Robinson",27,"1993","09","01","2019/2020","Defender","Sheffield United",505,90,415,"England",6,1,5,0,0,0,0,0,0,0,0,1,0,1,10,0,10,0,0,295,307,147
"1427","Jack Rodwell",30,"1991","03","11","2019/2020","Midfielder","Sheffield United",15,0,15,"England",1,0,1,0,0,0,0,0,0,0,0,0,0,0,0,0,0,0,0,-1,-1,-1
"1428","Jack Simpson",24,"1996","12","18","2019/2020","Defender","AFC Bournemouth",238,145,93,"England",4,2,2,0,0,0,0,0,0,0,0,0,0,0,5,3,2,0,0,-1,-1,-1
"1429","Jack Stacey",25,"1996","04","06","2019/2020","Midfielder","AFC Bournemouth",1550,746,804,"England",19,9,10,0,0,0,2,2,0,0,0,2,1,1,26,11,15,2,0,257,113,-1
"1430","Jack Stephens",27,"1994","01","27","2019/2020","Defender","Southampton",2452,1209,1243,"England",28,14,14,1,0,1,3,1,2,0,0,7,3,4,35,17,18,5,1,240,129,85
"1431","Jack Wilshere",29,"1992","01","01","2019/2020","Midfielder","West Ham United",211,110,101,"England",8,4,4,0,0,0,0,0,0,0,0,2,1,1,4,4,0,0,0,-1,-1,-1
"1432","Jack Young",0,"1970","01","01","2019/2020","Forward","Newcastle United",0,0,0,"England",0,0,0,0,0,0,0,0,0,0,0,0,0,0,0,0,0,0,0,-1,-1,-1
"1433","Jacob Maddox",22,"1998","11","03","2019/2020","Midfielder","Southampton",0,0,0,"England",0,0,0,0,0,0,0,0,0,0,0,0,0,0,0,0,0,0,0,-1,-1,-1
"1434","Jaïro Riedewald",24,"1996","09","09","2019/2020","Defender","Crystal Palace",763,279,484,"Netherlands",17,7,10,0,0,0,0,0,0,0,0,4,1,3,9,3,6,0,0,302,261,48
"1435","Jake Eastwood",24,"1996","10","03","2019/2020","Goalkeeper","Sheffield United",0,0,0,"England",0,0,0,0,0,0,0,0,0,0,0,0,0,0,0,0,0,0,0,-1,-1,-1
"1436","Jake Vokins",21,"2000","03","17","2019/2020","Defender","Southampton",90,90,0,"England",1,1,0,0,0,0,0,0,0,0,0,0,0,0,1,1,0,0,0,-1,-1,-1
"1437","Jamal Lascelles",27,"1993","11","11","2019/2020","Defender","Newcastle United",2079,1010,1069,"England",24,12,12,1,1,0,0,0,0,0,0,8,6,2,26,7,19,5,0,229,276,54
"1438","Jamal Lewis",23,"1998","01","25","2019/2020","Midfielder","Norwich City",2304,1214,1090,"Northern Ireland",28,15,13,1,1,0,0,0,0,0,0,2,1,1,54,28,26,4,0,228,330,-1
"1439","James Chester",32,"1989","01","23","2019/2020","Defender","Aston Villa",0,0,0,"Wales",0,0,0,0,0,0,0,0,0,0,0,0,0,0,0,0,0,0,0,-1,-1,-1
"1440","James Daly",21,"2000","01","12","2019/2020","Forward","Crystal Palace",0,0,0,"England",0,0,0,0,0,0,0,0,0,0,0,0,0,0,0,0,0,0,0,-1,-1,-1
"1441","James Garner",20,"2001","03","13","2019/2020","Defender","Manchester United",8,0,8,"England",1,0,1,0,0,0,0,0,0,0,0,0,0,0,1,0,1,0,0,-1,-1,-1
"1442","James Justin",21,"1999","07","11","2019/2020","Midfielder","Leicester City",1010,460,550,"England",13,6,7,0,0,0,1,1,0,0,0,5,5,0,12,1,11,1,0,369,147,-1
"1443","James Maddison",24,"1996","11","23","2019/2020","Midfielder","Leicester City",2628,1315,1313,"England",31,15,16,6,3,3,3,0,3,0,0,10,5,5,25,14,11,4,0,87,138,-1
"1444","James McArthur",33,"1987","10","07","2019/2020","Midfielder","Crystal Palace",3105,1607,1498,"Scotland",37,19,18,0,0,0,3,2,1,0,0,10,6,4,38,17,21,6,0,334,154,-1
"1445","James McCarthy",30,"1990","11","12","2019/2020","Midfielder","Crystal Palace",1668,787,881,"Republic of Ireland",33,15,18,0,0,0,0,0,0,0,0,7,4,3,27,10,17,9,0,337,341,-1
"1446","James Milner",35,"1986","01","04","2019/2020","Midfielder","Liverpool",926,560,366,"England",22,12,10,2,1,1,2,1,1,2,0,8,3,5,9,7,2,4,0,94,61,-1
"1447","James Tarkowski",28,"1992","11","19","2019/2020","Defender","Burnley",3420,1710,1710,"England",38,19,19,2,1,1,2,1,1,0,0,15,8,7,48,22,26,10,0,220,214,79
"1448","James Tomkins",32,"1989","03","29","2019/2020","Defender","Crystal Palace",1584,803,781,"England",18,9,9,1,0,1,1,1,0,0,0,3,1,2,23,12,11,5,0,216,190,93
"1449","James Ward-Prowse",26,"1994","11","01","2019/2020","Midfielder","Southampton",3420,1710,1710,"England",38,19,19,5,2,3,3,1,2,1,2,9,3,6,56,33,23,9,0,129,166,-1
"1450","Jamie Vardy",34,"1987","01","11","2019/2020","Forward","Leicester City",3034,1594,1440,"England",35,19,16,23,12,11,5,4,1,4,1,12,8,4,35,15,20,2,0,6,89,-1
"1451","Jan Bednarek",25,"1996","04","12","2019/2020","Defender","Southampton",3058,1530,1528,"Poland",34,17,17,1,1,0,1,0,1,0,0,7,3,4,53,30,23,4,0,247,240,126
"1452","Jan Vertonghen",34,"1987","04","24","2019/2020","Defender","Tottenham Hotspur",1644,689,955,"Belgium",23,9,14,1,0,1,1,1,0,0,0,5,3,2,23,7,16,2,0,224,217,78
"1453","Jannik Vestergaard",28,"1992","08","03","2019/2020","Defender","Southampton",1497,676,821,"Denmark",19,9,10,1,1,0,0,0,0,0,0,4,0,4,25,16,9,3,0,203,401,118
"1454","Japhet Tanganga",22,"1999","03","31","2019/2020","Defender","Tottenham Hotspur",526,256,270,"England",6,3,3,0,0,0,0,0,0,0,0,2,1,1,7,4,3,1,0,304,336,63
"1455","Jarrad Branthwaite",18,"2002","06","27","2019/2020","Midfielder","Everton",298,164,134,"England",4,2,2,0,0,0,0,0,0,0,0,1,0,1,5,4,1,0,0,420,420,-1
"1456","Jarrod Bowen",24,"1996","12","20","2019/2020","Forward","West Ham United",922,463,459,"England",13,6,7,1,1,0,4,3,1,0,0,1,0,1,13,7,6,0,0,162,10,-1
"1457","Javier Hernandez",32,"1988","06","01","2019/2020","Forward","West Ham United",107,24,83,"Mexico",2,1,1,1,0,1,0,0,0,0,0,0,0,0,3,2,1,0,0,-1,-1,-1
"1458","Javier Manquillo Gaitán",26,"1994","05","05","2019/2020","Defender","Newcastle United",1599,957,642,"Spain",21,12,9,0,0,0,1,0,1,0,0,7,4,3,20,12,8,5,0,377,201,53
"1459","Jay Rodriguez",31,"1989","07","29","2019/2020","Forward","Burnley",2007,927,1080,"England",36,19,17,8,3,5,1,1,0,1,0,14,8,6,32,13,19,1,0,44,230,-1
"1460","Jean-Philippe Gbamin",25,"1995","09","25","2019/2020","Midfielder","Everton",135,90,45,"Côte d'Ivoire",2,1,1,0,0,0,0,0,0,0,0,2,1,1,0,0,0,0,0,-1,-1,-1
"1461","Jed Steer",28,"1992","09","22","2019/2020","Goalkeeper","Aston Villa",8,0,8,"England",1,0,1,0,0,0,0,0,0,0,0,0,0,0,0,0,0,0,0,-1,-1,-1
"1462","Jeff Hendrick",29,"1992","01","31","2019/2020","Midfielder","Burnley",1935,1042,893,"Republic of Ireland",24,12,12,2,1,1,2,1,1,0,0,10,6,4,29,13,16,8,0,167,151,-1
"1463","Jefferson Lerma",26,"1994","10","25","2019/2020","Midfielder","AFC Bournemouth",2708,1404,1304,"Colombia",33,18,15,1,1,0,2,0,2,0,0,4,2,2,48,22,26,13,1,246,177,-1
"1464","Jeffrey Schlupp",28,"1992","12","23","2019/2020","Defender","Crystal Palace",1035,591,444,"Ghana",17,9,8,3,2,1,1,0,1,0,0,5,3,2,15,7,8,2,0,66,146,90
"1465","Jeremy Ngakia",20,"2000","09","07","2019/2020","Forward","West Ham United",441,261,180,"England",5,3,2,0,0,0,0,0,0,0,0,0,0,0,8,4,4,0,0,300,308,-1
"1466","Jesse Lingard",28,"1992","12","15","2019/2020","Midfielder","Manchester United",931,454,477,"England",22,10,12,1,0,1,0,0,0,0,0,5,2,3,13,4,9,3,0,155,353,-1
"1467","Jesús Vallejo Lázaro",24,"1997","01","05","2019/2020","Defender","Wolverhampton Wanderers",162,162,0,"Spain",2,2,0,0,0,0,0,0,0,0,0,0,0,0,5,5,0,1,0,-1,-1,-1
"1468","Jetro Willems",27,"1994","03","30","2019/2020","Defender","Newcastle United",1498,800,698,"Netherlands",19,11,8,2,1,1,2,1,1,0,0,4,3,1,24,11,13,0,0,135,115,114
"1469","Jimmy Dunne",23,"1997","10","19","2019/2020","Defender","Burnley",0,0,0,"Republic of Ireland",0,0,0,0,0,0,0,0,0,0,0,0,0,0,0,0,0,0,0,-1,-1,-1
"1470","João Cancelo",26,"1994","05","27","2019/2020","Defender","Manchester City",1205,729,476,"Portugal",17,10,7,0,0,0,0,0,0,0,0,8,6,2,7,4,3,4,0,361,338,2
"1471","João Manuel Neves Virginia",21,"1999","10","10","2019/2020","Goalkeeper","Everton",0,0,0,"Portugal",0,0,0,0,0,0,0,0,0,0,0,0,0,0,0,0,0,0,0,-1,-1,-1
"1472","João Moutinho",34,"1986","09","08","2019/2020","Midfielder","Wolverhampton Wanderers",3108,1516,1592,"Portugal",38,19,19,1,0,1,6,3,3,0,0,13,8,5,31,16,15,7,0,252,76,-1
"1473","João Pedro Junqueira de Jesus",19,"2001","09","26","2019/2020","Forward","Watford",22,16,6,"Brazil",3,1,2,0,0,0,0,0,0,0,0,0,0,0,1,1,0,0,0,-1,-1,-1
"1474","Joe Gomez",23,"1997","05","23","2019/2020","Defender","Liverpool",1999,1095,904,"England",28,15,13,0,0,0,0,0,0,0,0,13,7,6,16,8,8,7,0,342,313,7
"1475","Joe Hart",34,"1987","04","19","2019/2020","Goalkeeper","Burnley",0,0,0,"England",0,0,0,0,0,0,0,0,0,0,0,0,0,0,0,0,0,0,0,-1,-1,-1
"1476","Joel Matip",29,"1991","08","08","2019/2020","Defender","Liverpool",703,180,523,"Cameroon",9,3,6,1,1,0,0,0,0,0,0,3,0,3,5,2,3,0,0,122,299,5
"1477","Joel Mumbongo",22,"1999","01","09","2019/2020","Forward","Burnley",0,0,0,"Sweden",0,0,0,0,0,0,0,0,0,0,0,0,0,0,0,0,0,0,0,-1,-1,-1
"1478","Joel Ward",31,"1989","10","29","2019/2020","Defender","Crystal Palace",2383,1268,1115,"England",29,15,14,0,0,0,0,0,0,0,0,7,5,2,34,13,21,4,0,333,351,84
"1479","Joelinton Cassio Apolinário de Lira",24,"1996","08","14","2019/2020","Forward","Newcastle United",2698,1410,1288,"Brazil",38,19,19,2,1,1,2,0,2,0,0,11,7,4,43,15,28,7,0,193,180,-1
"1480","Johann Berg Guðmunds­son",30,"1990","10","27","2019/2020","Midfielder","Burnley",620,375,245,"Iceland",12,7,5,1,1,0,1,0,1,0,0,3,2,1,6,3,3,0,0,109,91,-1
"1481","John Egan",28,"1992","10","20","2019/2020","Defender","Sheffield United",3189,1609,1580,"Republic of Ireland",36,18,18,2,1,1,0,0,0,0,0,13,8,5,29,11,18,5,1,199,385,17
"1482","John Fleck",29,"1991","08","24","2019/2020","Midfielder","Sheffield United",2516,1229,1287,"Scotland",30,15,15,5,4,1,2,2,0,0,0,9,6,3,30,11,19,8,0,99,181,-1
"1483","John Lundstram",27,"1994","02","18","2019/2020","Midfielder","Sheffield United",2455,1140,1315,"England",34,17,17,5,4,1,3,2,1,0,0,12,7,5,29,10,19,5,0,97,130,-1
"1484","John McGinn",26,"1994","10","18","2019/2020","Midfielder","Aston Villa",2317,1160,1157,"Scotland",28,15,13,3,1,2,3,2,1,0,0,6,6,0,39,16,23,3,0,131,112,-1
"1485","John Ruddy",34,"1986","10","24","2019/2020","Goalkeeper","Wolverhampton Wanderers",0,0,0,"England",0,0,0,0,0,0,0,0,0,0,0,0,0,0,0,0,0,0,0,-1,-1,-1
"1486","John Stones",26,"1994","05","28","2019/2020","Defender","Manchester City",1119,624,495,"England",16,8,8,0,0,0,0,0,0,0,0,7,3,4,14,6,8,0,0,358,284,56
"1487","John-Kymani Gordon",18,"2003","02","13","2019/2020","Forward","Crystal Palace",0,0,0,"England",0,0,0,0,0,0,0,0,0,0,0,0,0,0,0,0,0,0,0,-1,-1,-1
"1488","Jonas Lössl",32,"1989","02","01","2019/2020","Goalkeeper","Everton",0,0,0,"Denmark",0,0,0,0,0,0,0,0,0,0,0,0,0,0,0,0,0,0,0,-1,-1,-1
"1489","Jonathan Kodjia",31,"1989","10","22","2019/2020","Forward","Aston Villa",112,38,74,"Côte d'Ivoire",6,2,4,0,0,0,0,0,0,0,0,0,0,0,4,1,3,1,0,-1,-1,-1
"1490","Jonjo Shelvey",29,"1992","02","27","2019/2020","Midfielder","Newcastle United",2124,1248,876,"England",26,16,10,6,3,3,2,1,1,0,0,8,5,3,31,16,15,3,0,71,160,-1
"1491","Jonny",27,"1994","03","03","2019/2020","Defender","Wolverhampton Wanderers",2891,1593,1298,"Spain",35,18,17,2,1,1,2,0,2,0,0,12,7,5,30,16,14,4,0,200,200,31
"1492","Jonny Evans",33,"1988","01","03","2019/2020","Defender","Leicester City",3386,1710,1676,"Northern Ireland",38,19,19,1,0,1,1,1,0,0,0,13,8,5,38,16,22,9,1,255,242,42
"1493","Jordan Ayew",29,"1991","09","11","2019/2020","Forward","Crystal Palace",3162,1624,1538,"Ghana",37,19,18,9,4,5,2,2,0,0,0,10,6,4,44,17,27,6,0,65,197,-1
"1494","Jordan Henderson",30,"1990","06","17","2019/2020","Midfielder","Liverpool",2244,992,1252,"England",30,14,16,4,2,2,5,2,3,0,0,15,7,8,14,5,9,2,0,107,56,-1
"1495","Jordan Pickford",27,"1994","03","07","2019/2020","Goalkeeper","Everton",3420,1710,1710,"England",38,19,19,0,0,0,0,0,0,0,0,9,6,3,49,18,31,2,0,365,358,89
"1496","Jordan Thomas",20,"2001","01","02","2019/2020","Defender","Norwich City",0,0,0,"England",1,0,1,0,0,0,0,0,0,0,0,0,0,0,0,0,0,0,0,-1,-1,-1
"1497","Jordon Ibe",25,"1995","12","08","2019/2020","Midfielder","AFC Bournemouth",48,22,26,"England",2,1,1,0,0,0,0,0,0,0,0,0,0,0,1,0,1,0,0,-1,-1,-1
"1498","Jorginho",29,"1991","12","20","2019/2020","Midfielder","Chelsea",2383,1200,1183,"Italy",31,15,16,4,3,1,2,0,2,3,0,6,5,1,39,13,26,10,0,111,162,-1
"1499","José Ángel Esmoris Tasende",24,"1997","01","04","2019/2020","Defender","Manchester City",421,241,180,"Spain",6,4,2,0,0,0,0,0,0,0,0,2,2,0,7,3,4,1,0,287,282,121
"1500","José Diogo Dalot Teixeira",22,"1999","03","18","2019/2020","Defender","Manchester United",65,2,63,"Portugal",4,1,3,0,0,0,0,0,0,0,0,2,1,1,0,0,0,0,0,-1,-1,-1
"1501","José Holebas",36,"1984","06","27","2019/2020","Defender","Watford",1024,486,538,"Greece",14,8,6,0,0,0,0,0,0,0,0,2,1,1,26,12,14,5,0,399,360,165
"1502","José Ignacio Peleteiro Ramallo",29,"1991","06","16","2019/2020","Midfielder","Aston Villa",333,167,166,"Spain",10,5,5,0,0,0,1,1,0,0,0,3,3,0,4,0,4,0,0,408,30,-1
"1503","Joseph Anang",0,"1970","01","01","2019/2020","Midfielder","West Ham United",0,0,0,"England",0,0,0,0,0,0,0,0,0,0,0,0,0,0,0,0,0,0,0,-1,-1,-1
"1504","Joseph Willock",21,"1999","08","20","2019/2020","Midfielder","Arsenal",844,340,504,"England",29,12,17,1,0,1,1,0,1,0,0,8,3,5,15,6,9,2,0,138,121,-1
"1505","Josh Benson",21,"1999","12","05","2019/2020","Midfielder","Burnley",0,0,0,"England",0,0,0,0,0,0,0,0,0,0,0,0,0,0,0,0,0,0,0,-1,-1,-1
"1506","Josh Brownhill",25,"1995","12","19","2019/2020","Midfielder","Burnley",805,355,450,"England",10,5,5,0,0,0,0,0,0,0,0,5,2,3,10,4,6,2,0,310,312,-1
"1507","Josh Martin",0,"1970","01","01","2019/2020","Midfielder","Norwich City",32,21,11,"England",5,2,3,0,0,0,0,0,0,0,0,0,0,0,1,1,0,0,0,-1,-1,-1
"1508","Joshua King",29,"1992","01","15","2019/2020","Forward","AFC Bournemouth",2020,1000,1020,"Norway",26,13,13,6,3,3,4,2,2,3,0,5,3,2,37,17,20,0,0,60,65,-1
"1509","Josip Drmic",28,"1992","08","08","2019/2020","Forward","Norwich City",635,352,283,"Switzerland",21,10,11,1,1,0,0,0,0,0,0,2,2,0,10,6,4,1,1,117,259,-1
"1510","Juan Marcos Foyth",23,"1998","01","12","2019/2020","Defender","Tottenham Hotspur",66,18,48,"Argentina",4,1,3,0,0,0,0,0,0,0,0,0,0,0,2,1,1,1,0,-1,-1,-1
"1511","Juan Mata",32,"1988","04","28","2019/2020","Midfielder","Manchester United",753,468,285,"Spain",19,11,8,0,0,0,2,2,0,0,0,5,5,0,6,4,2,1,0,387,35,-1
"1512","Junior Stanislas",31,"1989","11","26","2019/2020","Midfielder","AFC Bournemouth",710,283,427,"England",15,6,9,3,1,2,0,0,0,1,0,1,1,0,16,3,13,1,0,42,334,-1
"1513","Jürgen Locadia",27,"1993","11","07","2019/2020","Forward","Brighton & Hove Albion",86,22,64,"Netherlands",2,1,1,0,0,0,0,0,0,0,0,1,0,1,0,0,0,0,0,-1,-1,-1
"1514","Kaine Hayden",0,"1970","01","01","2019/2020","Midfielder","Aston Villa",0,0,0,"England",0,0,0,0,0,0,0,0,0,0,0,0,0,0,0,0,0,0,0,-1,-1,-1
"1515","Karl Darlow",30,"1990","10","08","2019/2020","Goalkeeper","Newcastle United",0,0,0,"England",0,0,0,0,0,0,0,0,0,0,0,0,0,0,0,0,0,0,0,-1,-1,-1
"1516","Kasper Schmeichel",34,"1986","11","05","2019/2020","Goalkeeper","Leicester City",3420,1710,1710,"Denmark",38,19,19,0,0,0,0,0,0,0,0,13,8,5,38,16,22,2,0,393,324,37
"1517","Keinan Davis",23,"1998","02","13","2019/2020","Midfielder","Aston Villa",538,291,247,"England",18,10,8,0,0,0,0,0,0,0,0,4,4,0,7,1,6,0,0,266,399,-1
"1518","Kelechi Iheanacho",24,"1996","10","03","2019/2020","Forward","Leicester City",962,452,510,"Nigeria",20,10,10,5,2,3,3,2,1,0,0,4,3,1,8,3,5,1,0,26,28,-1
"1519","Kelland Watts",21,"1999","11","03","2019/2020","Midfielder","Newcastle United",16,16,0,"England",1,1,0,0,0,0,0,0,0,0,0,0,0,0,1,1,0,0,0,-1,-1,-1
"1520","Ken Sema",27,"1993","09","30","2019/2020","Midfielder","Watford",0,0,0,"Sweden",0,0,0,0,0,0,0,0,0,0,0,0,0,0,0,0,0,0,0,-1,-1,-1
"1521","Kenny Mclean",29,"1992","01","08","2019/2020","Midfielder","Norwich City",2966,1391,1575,"Scotland",37,18,19,1,1,0,1,1,0,0,0,5,2,3,60,28,32,5,0,244,251,-1
"1522","Kepa Arrizabalaga",26,"1994","10","03","2019/2020","Goalkeeper","Chelsea",2970,1440,1530,"Spain",33,16,17,0,0,0,0,0,0,0,0,8,7,1,46,13,33,0,0,390,404,108
"1523","Kevin Danso",22,"1998","09","19","2019/2020","Defender","Southampton",276,163,113,"Austria",6,3,3,0,0,0,1,1,0,0,0,1,0,1,7,6,1,2,1,309,16,164
"1524","Kevin De Bruyne",29,"1991","06","28","2019/2020","Midfielder","Manchester City",2800,1403,1397,"Belgium",35,17,18,13,9,4,20,12,8,2,0,17,10,7,21,9,12,3,0,31,1,-1
"1525","Kevin Long",30,"1990","08","18","2019/2020","Defender","Burnley",562,270,292,"Republic of Ireland",8,3,5,0,0,0,0,0,0,0,0,3,0,3,5,4,1,0,0,321,409,12
"1526","Ki-Jana Hoever",19,"2002","01","18","2019/2020","Defender","Liverpool",0,0,0,"Netherlands",0,0,0,0,0,0,0,0,0,0,0,0,0,0,0,0,0,0,0,-1,-1,-1
"1527","Kieran Tierney",23,"1997","06","05","2019/2020","Defender","Arsenal",992,630,362,"Scotland",15,8,7,1,1,0,1,1,0,0,0,3,1,2,14,10,4,2,0,168,153,81
"1528","Kieron Freeman",29,"1992","03","21","2019/2020","Defender","Sheffield United",5,0,5,"Wales",2,1,1,0,0,0,0,0,0,0,0,0,0,0,0,0,0,0,0,-1,-1,-1
"1529","Konstantinos Mavropanos",23,"1997","12","11","2019/2020","Defender","Arsenal",0,0,0,"Greece",0,0,0,0,0,0,0,0,0,0,0,0,0,0,0,0,0,0,0,-1,-1,-1
"1530","Kortney Hause",25,"1995","07","16","2019/2020","Defender","Aston Villa",1544,810,734,"England",18,9,9,1,1,0,0,0,0,0,0,2,2,0,32,18,14,3,0,213,333,153
"1531","Kurt Zouma",26,"1994","10","27","2019/2020","Defender","Chelsea",2342,1128,1214,"France",28,14,14,0,0,0,0,0,0,0,0,7,6,1,37,8,29,6,0,391,406,112
"1532","Kyle Walker",30,"1990","05","28","2019/2020","Defender","Manchester City",2397,1073,1324,"England",29,14,15,1,1,0,4,2,2,0,0,14,8,6,24,6,18,5,0,239,87,27
"1533","Kyle Walker-Peters",24,"1997","04","13","2019/2020","Defender","Southampton",943,493,450,"England",13,7,6,0,0,0,0,0,0,0,0,3,1,2,12,6,6,1,0,414,391,58
"1534","Leander Dendoncker",26,"1995","04","15","2019/2020","Midfielder","Wolverhampton Wanderers",2794,1499,1295,"Belgium",38,19,19,4,3,1,0,0,0,0,0,13,8,5,30,13,17,5,0,128,379,-1
"1535","Leandro Trossard",26,"1994","12","04","2019/2020","Forward","Brighton & Hove Albion",2013,1256,757,"Belgium",31,17,14,5,4,1,3,3,0,0,0,6,3,3,33,21,12,0,0,80,97,-1
"1536","Lee Grant",38,"1983","01","27","2019/2020","Goalkeeper","Manchester United",0,0,0,"England",0,0,0,0,0,0,0,0,0,0,0,0,0,0,0,0,0,0,0,-1,-1,-1
"1537","Leighton Baines",36,"1984","12","11","2019/2020","Defender","Everton",402,118,284,"England",8,3,5,0,0,0,0,0,0,0,0,1,0,1,8,2,6,0,0,265,319,148
"1538","Leon Balogun",32,"1988","06","28","2019/2020","Defender","Brighton & Hove Albion",0,0,0,"Nigeria",0,0,0,0,0,0,0,0,0,0,0,0,0,0,0,0,0,0,0,-1,-1,-1
"1539","Leon Clarke",36,"1985","02","10","2019/2020","Forward","Sheffield United",33,13,20,"England",2,1,1,0,0,0,0,0,0,0,0,0,0,0,2,0,2,0,0,-1,-1,-1
"1540","Leonardo Campana Romero",20,"2000","07","24","2019/2020","Forward","Wolverhampton Wanderers",0,0,0,"Ecuador",0,0,0,0,0,0,0,0,0,0,0,0,0,0,0,0,0,0,0,-1,-1,-1
"1541","Leroy Sané",25,"1996","01","11","2019/2020","Midfielder","Manchester City",11,11,0,"Germany",1,1,0,0,0,0,0,0,0,0,0,1,1,0,0,0,0,0,0,-1,-1,-1
"1542","Lewis Bate",0,"1970","01","01","2019/2020","Midfielder","Chelsea",0,0,0,"England",0,0,0,0,0,0,0,0,0,0,0,0,0,0,0,0,0,0,0,-1,-1,-1
"1543","Lewis Cook",24,"1997","02","03","2019/2020","Midfielder","AFC Bournemouth",1345,693,652,"England",27,15,12,0,0,0,0,0,0,0,0,3,2,1,28,10,18,5,0,308,269,-1
"1544","Lewis Dunk",29,"1991","11","21","2019/2020","Defender","Brighton & Hove Albion",3231,1611,1620,"England",36,18,18,3,1,2,3,2,1,0,0,9,4,5,47,23,24,9,0,182,161,92
"1545","Lewis Jack Gibson",20,"2000","07","19","2019/2020","Defender","Everton",0,0,0,"England",0,0,0,0,0,0,0,0,0,0,0,0,0,0,0,0,0,0,0,-1,-1,-1
"1546","Liam Gibson",24,"1997","04","25","2019/2020","Defender","Newcastle United",0,0,0,"England",0,0,0,0,0,0,0,0,0,0,0,0,0,0,0,0,0,0,0,-1,-1,-1
"1547","Lloyd Kelly",22,"1998","10","01","2019/2020","Defender","AFC Bournemouth",638,360,278,"England",8,4,4,0,0,0,0,0,0,0,0,1,1,0,14,6,8,2,0,272,325,157
"1548","Lovre Kalinić",31,"1990","04","03","2019/2020","Goalkeeper","Aston Villa",0,0,0,"Croatia",0,0,0,0,0,0,0,0,0,0,0,0,0,0,0,0,0,0,0,-1,-1,-1
"1549","Lucas Digne",27,"1993","07","20","2019/2020","Defender","Everton",3035,1570,1465,"France",35,18,17,0,0,0,7,6,1,0,0,9,6,3,42,16,26,6,0,366,51,76
"1550","Lucas Rodrigues Moura da Silva",28,"1992","08","13","2019/2020","Midfielder","Tottenham Hotspur",2246,1160,1086,"Brazil",35,17,18,4,1,3,4,4,0,0,0,8,6,2,27,12,15,3,0,108,85,-1
"1551","Lucas Torreira",25,"1996","02","11","2019/2020","Midfielder","Arsenal",1509,799,710,"Uruguay",29,16,13,1,0,1,1,0,1,0,0,6,3,3,23,14,9,7,0,205,194,-1
"1552","Luka Milivojević",30,"1991","04","07","2019/2020","Midfielder","Crystal Palace",2514,1270,1244,"Serbia",31,16,15,3,1,2,1,0,1,2,0,8,5,3,36,15,21,12,0,143,225,-1
"1553","Lukas Jensen",0,"1970","01","01","2019/2020","Goalkeeper","Burnley",0,0,0,"Denmark",0,0,0,0,0,0,0,0,0,0,0,0,0,0,0,0,0,0,0,-1,-1,-1
"1554","Lukas Rupp",30,"1991","01","08","2019/2020","Midfielder","Norwich City",698,210,488,"Germany",12,6,6,0,0,0,0,0,0,0,0,3,2,1,17,4,13,1,0,289,302,-1
"1555","Luke Cundle",0,"1970","01","01","2019/2020","Midfielder","Wolverhampton Wanderers",0,0,0,"England",0,0,0,0,0,0,0,0,0,0,0,0,0,0,0,0,0,0,0,-1,-1,-1
"1556","Luke Freeman",29,"1992","03","22","2019/2020","Forward","Sheffield United",360,178,182,"England",11,4,7,0,0,0,0,0,0,0,0,4,2,2,5,2,3,2,0,338,390,-1
"1557","Luke Shaw",25,"1995","07","12","2019/2020","Defender","Manchester United",1734,864,870,"England",24,13,11,0,0,0,0,0,0,0,0,9,5,4,15,6,9,7,0,385,350,9
"1558","Luke Thomas",0,"1970","01","01","2019/2020","Midfielder","Leicester City",268,178,90,"England",3,2,1,0,0,0,1,1,0,0,0,1,1,0,4,1,3,0,0,-1,-1,-1
"1559","Lys Mousset",25,"1996","02","08","2019/2020","Forward","Sheffield United",1232,524,708,"France",30,14,16,6,3,3,4,4,0,0,0,11,6,5,14,3,11,1,0,29,27,-1
"1560","Maarten Stekelenburg",38,"1982","09","22","2019/2020","Goalkeeper","Everton",0,0,0,"Netherlands",0,0,0,0,0,0,0,0,0,0,0,0,0,0,0,0,0,0,0,-1,-1,-1
"1561","Mace Lewin Goodridge",21,"1999","09","13","2019/2020","Midfielder","Burnley",0,0,0,"England",0,0,0,0,0,0,0,0,0,0,0,0,0,0,0,0,0,0,0,-1,-1,-1
"1562","Mahmoud Ibrahim Hassan",26,"1994","10","01","2019/2020","Midfielder","Aston Villa",1951,880,1071,"Egypt",34,17,17,6,4,2,1,1,0,0,0,5,5,0,25,10,15,4,1,58,209,-1
"1563","Mamadou Sakho",31,"1990","02","13","2019/2020","Defender","Crystal Palace",932,382,550,"France",14,6,8,0,0,0,0,0,0,0,0,3,2,1,19,5,14,2,1,297,292,151
"1564","Manuel Lanzini",28,"1993","02","15","2019/2020","Midfielder","West Ham United",1377,680,697,"Argentina",24,13,11,0,0,0,2,1,1,0,0,3,2,1,27,16,11,1,0,354,100,-1
"1565","Marc Albrighton",31,"1989","11","18","2019/2020","Midfielder","Leicester City",863,388,475,"England",20,8,12,0,0,0,3,3,0,0,0,6,4,2,10,5,5,2,0,380,22,-1
"1566","Marc Guehi",20,"2000","07","13","2019/2020","Defender","Chelsea",0,0,0,"England",0,0,0,0,0,0,0,0,0,0,0,0,0,0,0,0,0,0,0,-1,-1,-1
"1567","Marco Stiepermann",30,"1991","02","09","2019/2020","Midfielder","Norwich City",1184,585,599,"Germany",24,10,14,0,0,0,0,0,0,0,0,1,1,0,32,17,15,6,0,348,326,-1
"1568","Marcos Alonso",30,"1990","12","28","2019/2020","Defender","Chelsea",1430,695,735,"Spain",18,8,10,4,2,2,2,0,2,0,0,6,5,1,18,3,15,4,0,70,96,52
"1569","Marcus Rashford",23,"1997","10","31","2019/2020","Forward","Manchester United",2655,1257,1398,"England",31,15,16,17,12,5,7,3,4,6,2,9,4,5,26,12,14,3,0,17,39,-1
"1570","Mario Vrančić",31,"1989","05","23","2019/2020","Midfielder","Norwich City",626,403,223,"Bosnia and Herzegovina",20,12,8,1,1,0,0,0,0,0,0,1,0,1,17,9,8,3,0,118,273,-1
"1571","Mark Noble",33,"1987","05","08","2019/2020","Midfielder","West Ham United",2686,1286,1400,"England",33,15,18,4,2,2,3,2,1,3,0,7,3,4,43,22,21,5,0,127,135,-1
"1572","Mark Travers",21,"1999","05","18","2019/2020","Goalkeeper","AFC Bournemouth",90,90,0,"Republic of Ireland",1,1,0,0,0,0,0,0,0,0,0,0,0,0,2,2,0,0,0,-1,-1,-1
"1573","Martin Dúbravka",32,"1989","01","15","2019/2020","Goalkeeper","Newcastle United",3420,1710,1710,"Slovakia",38,19,19,0,0,0,0,0,0,0,0,11,7,4,51,20,31,0,0,375,375,102
"1574","Martin Kelly",31,"1990","04","27","2019/2020","Defender","Crystal Palace",1550,701,849,"England",19,9,10,0,0,0,1,0,1,0,0,6,4,2,16,6,10,0,0,332,204,32
"1575","Martín Montoya",30,"1991","04","14","2019/2020","Defender","Brighton & Hove Albion",1901,1006,895,"Spain",27,14,13,0,0,0,1,1,0,0,0,6,3,3,31,15,16,5,0,395,210,117
"1576","Marvelous Nakamba",27,"1994","01","19","2019/2020","Midfielder","Aston Villa",1835,867,968,"Zimbabwe",29,16,13,0,0,0,0,0,0,0,0,5,5,0,35,13,22,5,0,279,272,-1
"1577","Mason Greenwood",19,"2001","10","01","2019/2020","Midfielder","Manchester United",1310,747,563,"England",31,16,15,10,7,3,1,0,1,0,0,9,5,4,10,7,3,0,0,4,188,-1
"1578","Mason Holgate",24,"1996","10","22","2019/2020","Defender","Everton",2053,937,1116,"England",27,14,13,0,0,0,3,0,3,0,0,7,6,1,28,5,23,5,0,397,102,70
"1579","Mason Mount",22,"1999","01","10","2019/2020","Midfielder","Chelsea",2874,1415,1459,"England",37,18,19,7,4,3,5,1,4,0,0,8,7,1,44,14,30,3,0,82,81,-1
"1580","Matěj Vydra",28,"1992","05","01","2019/2020","Forward","Burnley",812,341,471,"Czech Republic",19,7,12,2,1,1,1,0,1,0,0,6,2,4,7,1,6,0,0,77,128,-1
"1581","Mateo Kovačić",26,"1994","05","06","2019/2020","Midfielder","Chelsea",2073,994,1079,"Croatia",31,15,16,1,0,1,3,0,3,0,0,6,5,1,37,10,27,8,0,226,106,-1
"1582","Mathew Ryan",29,"1992","04","08","2019/2020","Goalkeeper","Brighton & Hove Albion",3420,1710,1710,"Australia",38,19,19,0,0,0,0,0,0,0,0,9,4,5,51,25,26,0,0,405,377,100
"1583","Matias Ezequiel Schelotto",31,"1989","05","23","2019/2020","Defender","Brighton & Hove Albion",362,186,176,"Italy",8,5,3,0,0,0,0,0,0,0,0,1,1,0,7,4,3,2,0,267,277,141
"1584","Matt Doherty",29,"1992","01","16","2019/2020","Defender","Wolverhampton Wanderers",2840,1531,1309,"Republic of Ireland",36,19,17,4,3,1,3,2,1,0,0,13,8,5,26,11,15,1,0,130,139,16
"1585","Matt Macey",26,"1994","09","09","2019/2020","Goalkeeper","Arsenal",0,0,0,"England",0,0,0,0,0,0,0,0,0,0,0,0,0,0,0,0,0,0,0,-1,-1,-1
"1586","Matt Ritchie",31,"1989","09","10","2019/2020","Midfielder","Newcastle United",1316,705,611,"Scotland",18,9,9,2,2,0,1,1,0,0,1,7,4,3,16,6,10,4,0,113,184,-1
"1587","Matt Targett",25,"1995","09","18","2019/2020","Defender","Aston Villa",2295,1104,1191,"England",28,14,14,1,1,0,2,0,2,0,0,5,5,0,37,14,23,4,0,234,165,115
"1588","Mattéo Guendouzi Olié",22,"1999","04","14","2019/2020","Midfielder","Arsenal",1747,826,921,"France",24,11,13,0,0,0,1,1,0,0,0,4,2,2,30,15,15,6,0,381,212,-1
"1589","Matthew Longstaff",21,"2000","03","21","2019/2020","Midfielder","Newcastle United",573,189,384,"England",9,4,5,2,1,1,0,0,0,0,0,2,2,0,9,1,8,1,0,50,296,-1
"1590","Matthew Lowton",31,"1989","06","09","2019/2020","Defender","Burnley",1530,630,900,"England",17,7,10,0,0,0,1,0,1,0,0,6,5,1,30,7,23,2,0,318,195,143
"1591","Matthew Smith",20,"2000","10","05","2019/2020","Defender","Arsenal",0,0,0,"England",0,0,0,0,0,0,0,0,0,0,0,0,0,0,0,0,0,0,0,-1,-1,-1
"1592","Matty James",29,"1991","07","22","2019/2020","Midfielder","Leicester City",5,5,0,"England",1,1,0,0,0,0,0,0,0,0,0,0,0,0,0,0,0,0,0,-1,-1,-1
"1593","Max Kilman",23,"1997","05","23","2019/2020","Defender","Wolverhampton Wanderers",184,90,94,"England",3,1,2,0,0,0,0,0,0,0,0,0,0,0,2,1,1,0,0,-1,-1,-1
"1594","Max Meyer",25,"1995","09","18","2019/2020","Midfielder","Crystal Palace",649,324,325,"Germany",17,10,7,0,0,0,0,0,0,0,0,2,2,0,11,3,8,1,0,335,344,-1
"1595","Max Thompson",19,"2002","02","09","2019/2020","Midfielder","Burnley",2,0,2,"England",1,0,1,0,0,0,0,0,0,0,0,0,0,0,0,0,0,0,0,-1,-1,-1
"1596","Maximillian James Aarons",21,"2000","01","04","2019/2020","Midfielder","Norwich City",3240,1620,1620,"England",36,18,18,0,0,0,1,1,0,0,0,5,2,3,68,34,34,7,0,347,252,-1
"1597","Maya Yoshida",32,"1988","08","24","2019/2020","Defender","Southampton",558,288,270,"Japan",8,5,3,0,0,0,0,0,0,0,0,1,0,1,17,14,3,1,0,328,355,168
"1598","Mbwana Ally Samatta",28,"1992","12","13","2019/2020","Forward","Aston Villa",946,438,508,"Tanzania",14,7,7,1,0,1,0,0,0,0,0,3,3,0,17,8,9,1,0,154,306,-1
"1599","Mesut Özil",32,"1988","10","15","2019/2020","Midfielder","Arsenal",1449,846,603,"Germany",18,10,8,1,1,0,2,2,0,0,0,4,3,1,20,11,9,1,0,215,111,-1
"1600","Michael Keane",28,"1993","01","11","2019/2020","Defender","Everton",2556,1278,1278,"England",31,15,16,2,0,2,0,0,0,0,0,8,5,3,38,16,22,3,0,194,369,99
"1601","Michael McGovern",36,"1984","07","12","2019/2020","Goalkeeper","Norwich City",158,90,68,"Northern Ireland",2,1,1,0,0,0,0,0,0,0,0,0,0,0,5,5,0,0,0,-1,-1,-1
"1602","Michael Obafemi",20,"2000","07","06","2019/2020","Forward","Southampton",660,219,441,"Republic of Ireland",21,10,11,3,0,3,2,0,2,0,0,6,2,4,11,4,7,1,0,33,29,-1
"1603","Michael Verrips",24,"1996","12","03","2019/2020","Goalkeeper","Sheffield United",0,0,0,"Netherlands",0,0,0,0,0,0,0,0,0,0,0,0,0,0,0,0,0,0,0,-1,-1,-1
"1604","Michail Antonio",31,"1990","03","28","2019/2020","Midfielder","West Ham United",1770,785,985,"England",24,11,13,10,4,6,3,2,1,1,0,3,0,3,29,14,15,3,0,21,90,-1
"1605","Michel Vorm",37,"1983","10","20","2019/2020","Goalkeeper","Tottenham Hotspur",0,0,0,"Netherlands",0,0,0,0,0,0,0,0,0,0,0,0,0,0,0,0,0,0,0,-1,-1,-1
"1606","Michy Batshuayi",27,"1993","10","02","2019/2020","Forward","Chelsea",226,142,84,"Belgium",16,8,8,1,0,1,1,0,1,0,0,3,2,1,7,5,2,0,0,-1,-1,-1
"1607","Miguel Ángel Almirón Rejala",27,"1994","02","10","2019/2020","Midfielder","Newcastle United",3034,1659,1375,"Paraguay",36,19,17,4,2,2,2,2,0,0,0,11,7,4,43,19,24,5,0,133,196,-1
"1608","Mihai Alexandru Dobre",22,"1998","08","30","2019/2020","Midfielder","AFC Bournemouth",0,0,0,"Romania",0,0,0,0,0,0,0,0,0,0,0,0,0,0,0,0,0,0,0,-1,-1,-1
"1609","Mohamed Salah",28,"1992","06","15","2019/2020","Forward","Liverpool",2888,1580,1308,"Egypt",34,18,16,19,15,4,10,4,6,3,0,14,7,7,26,13,13,1,0,14,23,-1
"1610","Moise Kean",21,"2000","02","28","2019/2020","Forward","Everton",834,414,420,"Italy",29,13,16,2,2,0,2,1,1,0,0,7,5,2,12,7,5,1,0,83,42,-1
"1611","Morgan Gibbs-White",21,"2000","01","27","2019/2020","Midfielder","Wolverhampton Wanderers",124,124,0,"England",7,6,1,0,0,0,0,0,0,0,0,3,2,1,1,1,0,0,0,-1,-1,-1
"1612","Morgan Schneiderlin",31,"1989","11","08","2019/2020","Midfielder","Everton",1004,462,542,"France",15,6,9,0,0,0,0,0,0,0,0,1,0,1,15,6,9,6,1,394,376,-1
"1613","Moritz Leitner",28,"1992","12","08","2019/2020","Midfielder","Norwich City",686,307,379,"Germany",9,4,5,0,0,0,0,0,0,0,0,1,0,1,14,10,4,1,0,350,267,-1
"1614","Moussa Djenepo",22,"1998","06","15","2019/2020","Midfielder","Southampton",926,628,298,"Mali",18,11,7,2,0,2,2,2,0,0,0,4,2,2,12,7,5,5,1,93,59,-1
"1615","Moussa Sissoko",31,"1989","08","16","2019/2020","Midfielder","Tottenham Hotspur",2455,1350,1105,"France",29,15,14,2,2,0,1,1,0,0,0,6,5,1,28,11,17,8,0,185,228,-1
"1616","Muhamed Bešić",28,"1992","09","10","2019/2020","Midfielder","Sheffield United",245,102,143,"Bosnia and Herzegovina",9,3,6,0,0,0,0,0,0,0,0,3,2,1,2,1,1,2,0,-1,-1,-1
"1617","N'Golo Kanté",30,"1991","03","29","2019/2020","Midfielder","Chelsea",1733,816,917,"France",22,11,11,3,1,2,0,0,0,0,0,3,2,1,24,9,15,4,0,104,417,-1
"1618","Nabil Bentaleb",26,"1994","11","24","2019/2020","Midfielder","Newcastle United",749,287,462,"Algeria",12,6,6,0,0,0,0,0,0,0,0,3,2,1,12,4,8,2,0,285,303,-1
"1619","Naby Deco Keïta",26,"1995","02","10","2019/2020","Midfielder","Liverpool",814,275,539,"Guinea",18,7,11,2,1,1,3,1,2,0,0,9,4,5,7,4,3,1,0,86,17,-1
"1620","Nacho Monreal",35,"1986","02","26","2019/2020","Defender","Arsenal",270,90,180,"Spain",3,1,2,0,0,0,0,0,0,0,0,1,0,1,4,1,3,0,0,-1,-1,-1
"1621","Nampalys Mendy",28,"1992","06","23","2019/2020","Midfielder","Leicester City",291,110,181,"France",7,3,4,0,0,0,0,0,0,0,0,2,2,0,3,0,3,0,0,286,280,-1
"1622","Nathan Aké",26,"1995","02","18","2019/2020","Defender","AFC Bournemouth",2505,1335,1170,"Netherlands",29,16,13,2,1,1,2,2,0,0,0,4,3,1,45,22,23,2,0,189,168,128
"1623","Nathan Holland",22,"1998","06","19","2019/2020","Midfielder","West Ham United",31,12,19,"England",2,1,1,0,0,0,0,0,0,0,0,0,0,0,1,0,1,0,0,-1,-1,-1
"1624","Nathan Redmond",27,"1994","03","06","2019/2020","Midfielder","Southampton",2771,1241,1530,"England",32,15,17,4,0,4,4,1,3,0,0,7,2,5,48,28,20,2,0,126,103,-1
"1625","Nathan Tella",21,"1999","07","05","2019/2020","Midfielder","Southampton",2,0,2,"England",1,0,1,0,0,0,0,0,0,0,0,1,0,1,0,0,0,0,0,-1,-1,-1
"1626","Nathaniel Chalobah",26,"1994","12","12","2019/2020","Midfielder","Watford",925,422,503,"England",22,12,10,0,0,0,1,0,1,0,0,7,6,1,12,5,7,1,0,283,133,-1
"1627","Nathaniel Phillips",24,"1997","03","21","2019/2020","Defender","Liverpool",0,0,0,"England",0,0,0,0,0,0,0,0,0,0,0,0,0,0,0,0,0,0,0,-1,-1,-1
"1628","Neal Maupay",24,"1996","08","14","2019/2020","Forward","Brighton & Hove Albion",2769,1442,1327,"France",37,19,18,10,5,5,3,2,1,1,1,9,4,5,36,17,19,3,0,47,136,-1
"1629","Neco Williams",20,"2001","04","13","2019/2020","Midfielder","Liverpool",230,85,145,"Wales",6,3,3,0,0,0,0,0,0,0,0,2,2,0,2,0,2,1,0,-1,-1,-1
"1630","Neil Taylor",32,"1989","02","07","2019/2020","Defender","Aston Villa",1089,594,495,"Wales",14,8,6,0,0,0,0,0,0,0,0,3,3,0,24,14,10,2,0,419,281,158
"1631","Nemanja Matić",32,"1988","08","01","2019/2020","Midfielder","Manchester United",1583,764,819,"Serbia",21,9,12,0,0,0,2,1,1,0,0,11,5,6,11,6,5,3,0,388,124,-1
"1632","Nick Pope",29,"1992","04","19","2019/2020","Goalkeeper","Burnley",3420,1710,1710,"England",38,19,19,0,0,0,0,0,0,0,0,15,8,7,48,22,26,1,0,316,418,80
"1633","Nicolas Otamendi",33,"1988","02","12","2019/2020","Defender","Manchester City",1710,825,885,"Argentina",24,12,12,2,2,0,0,0,0,0,0,9,6,3,18,5,13,3,0,140,318,35
"1634","Nicolas Pépé",25,"1995","09","29","2019/2020","Forward","Arsenal",2012,1130,882,"Côte d'Ivoire",31,17,14,5,3,2,5,5,0,1,0,7,5,2,30,18,12,4,0,79,43,-1
"1635","Nikola Tavares",22,"1999","01","17","2019/2020","Defender","Crystal Palace",0,0,0,"England",0,0,0,0,0,0,0,0,0,0,0,0,0,0,0,0,0,0,0,-1,-1,-1
"1636","Nya Kirby",21,"2000","01","31","2019/2020","Midfielder","Crystal Palace",0,0,0,"England",0,0,0,0,0,0,0,0,0,0,0,0,0,0,0,0,0,0,0,-1,-1,-1
"1637","Odion Jude Ighalo",31,"1989","06","16","2019/2020","Forward","Manchester United",90,37,53,"Nigeria",11,5,6,0,0,0,0,0,0,0,0,7,3,4,0,0,0,0,0,-1,-1,-1
"1638","Oleksandr Zinchenko",24,"1996","12","15","2019/2020","Midfielder","Manchester City",1272,507,765,"Ukraine",19,7,12,0,0,0,0,0,0,0,0,9,4,5,12,4,8,2,1,359,283,-1
"1639","Oliver McBurnie",24,"1996","06","04","2019/2020","Forward","Sheffield United",2118,1155,963,"Scotland",36,19,17,6,5,1,0,0,0,0,0,13,8,5,24,12,12,4,0,69,382,-1
"1640","Oliver Norwood",30,"1991","04","12","2019/2020","Midfielder","Sheffield United",3101,1649,1452,"Northern Ireland",38,19,19,1,1,0,1,1,0,1,0,13,8,5,35,14,21,8,0,254,254,-1
"1641","Oliver Skipp",20,"2000","09","16","2019/2020","Midfielder","Tottenham Hotspur",73,16,57,"England",7,4,3,0,0,0,0,0,0,0,0,2,2,0,1,0,1,0,0,-1,-1,-1
"1642","Olivier Giroud",34,"1986","09","30","2019/2020","Forward","Chelsea",999,613,386,"France",18,9,9,8,5,3,0,0,0,0,0,4,4,0,16,2,14,1,0,2,416,-1
"1643","Ondrej Duda",26,"1994","12","05","2019/2020","Midfielder","Norwich City",729,403,326,"Slovakia",10,6,4,0,0,0,0,0,0,0,0,3,2,1,9,3,6,0,0,291,301,-1
"1644","Onel Lázaro Hernández Mayea",28,"1993","02","01","2019/2020","Midfielder","Norwich City",1379,731,648,"Germany",26,12,14,1,1,0,2,1,1,0,0,3,0,3,32,18,14,0,0,184,105,-1
"1645","Onyinye Wilfred Ndidi",24,"1996","12","16","2019/2020","Midfielder","Leicester City",2674,1399,1275,"Nigeria",32,16,16,2,1,1,1,0,1,0,0,12,8,4,29,11,18,6,0,183,256,-1
"1646","Oriol Romeu",29,"1991","09","24","2019/2020","Midfielder","Southampton",1856,812,1044,"Spain",30,14,16,0,0,0,0,0,0,0,0,8,3,5,35,20,15,5,0,314,378,-1
"1647","Oskar Buur",23,"1998","03","31","2019/2020","Defender","Wolverhampton Wanderers",0,0,0,"Denmark",0,0,0,0,0,0,0,0,0,0,0,0,0,0,0,0,0,0,0,-1,-1,-1
"1648","Oumar Niasse",31,"1990","04","18","2019/2020","Forward","Everton",19,2,17,"Senegal",3,1,2,0,0,0,0,0,0,0,0,0,0,0,0,0,0,0,0,-1,-1,-1
"1649","Owen Otasowie",0,"1970","01","01","2019/2020","Midfielder","Wolverhampton Wanderers",0,0,0,"England",0,0,0,0,0,0,0,0,0,0,0,0,0,0,0,0,0,0,0,-1,-1,-1
"1650","Pablo Fornals Malla",25,"1996","02","22","2019/2020","Midfielder","West Ham United",2177,1046,1131,"Spain",36,18,18,2,1,1,5,3,2,0,0,7,3,4,34,16,18,3,0,174,46,-1
"1651","Pablo Marí Villar",27,"1993","08","31","2019/2020","Defender","Arsenal",114,90,24,"Spain",2,1,1,0,0,0,0,0,0,0,0,1,1,0,0,0,0,0,0,-1,-1,-1
"1652","Pablo Zabaleta",36,"1985","01","16","2019/2020","Defender","West Ham United",589,268,321,"Argentina",10,5,5,0,0,0,0,0,0,0,0,2,1,1,13,6,7,2,0,355,290,159
"1653","Panagiotis Retsos",22,"1998","08","09","2019/2020","Defender","Sheffield United",0,0,0,"Greece",0,0,0,0,0,0,0,0,0,0,0,0,0,0,0,0,0,0,0,-1,-1,-1
"1654","Pascal Groß",29,"1991","06","15","2019/2020","Midfielder","Brighton & Hove Albion",1804,846,958,"Germany",29,14,15,2,1,1,4,0,4,0,0,6,3,3,29,13,16,4,0,152,53,-1
"1655","Patrick Cutrone",23,"1998","01","03","2019/2020","Forward","Wolverhampton Wanderers",291,122,169,"Italy",12,6,6,2,2,0,0,0,0,0,0,4,2,2,4,2,2,0,0,9,346,-1
"1656","Patrick Roberts",24,"1997","02","05","2019/2020","Midfielder","Norwich City",23,14,9,"England",3,1,2,0,0,0,0,0,0,0,0,0,0,0,1,1,0,0,0,-1,-1,-1
"1657","Patrick van Aanholt",30,"1990","08","29","2019/2020","Defender","Crystal Palace",2511,1258,1253,"Netherlands",29,15,14,3,1,2,2,1,1,1,0,9,6,3,37,14,23,0,0,145,182,96
"1658","Paul Dummett",29,"1991","09","26","2019/2020","Defender","Newcastle United",1229,610,619,"Wales",16,7,9,0,0,0,0,0,0,0,0,4,2,2,18,5,13,2,0,376,380,95
"1659","Paul Pogba",28,"1993","03","15","2019/2020","Midfielder","Manchester United",1204,637,567,"France",16,8,8,1,0,1,3,2,1,0,1,6,2,4,8,6,2,1,0,191,44,-1
"1660","Paulo Dino Gazzaniga",29,"1992","01","02","2019/2020","Goalkeeper","Tottenham Hotspur",1612,720,892,"Argentina",18,8,10,0,0,0,0,0,0,0,0,2,1,1,23,10,13,1,0,417,398,86
"1661","Pedro Lomba Neto",21,"2000","03","09","2019/2020","Forward","Wolverhampton Wanderers",928,484,444,"Portugal",29,14,15,3,0,3,3,3,0,0,0,10,7,3,10,3,7,3,0,55,26,-1
"1662","Pedro Rodriguez",33,"1987","07","28","2019/2020","Midfielder","Chelsea",661,407,254,"Spain",11,8,3,1,1,0,1,1,0,0,0,3,3,0,12,4,8,1,0,121,92,-1
"1663","Pepe Reina",38,"1982","08","31","2019/2020","Goalkeeper","Aston Villa",1080,450,630,"Spain",12,5,7,0,0,0,0,0,0,0,0,2,2,0,18,6,12,1,0,294,300,120
"1664","Phil Bardsley",35,"1985","06","28","2019/2020","Defender","Burnley",1890,1080,810,"Scotland",21,12,9,0,0,0,1,1,0,0,0,9,3,6,18,15,3,6,0,322,211,21
"1665","Phil Jagielka",38,"1982","08","17","2019/2020","Defender","Sheffield United",240,124,116,"England",6,4,2,0,0,0,0,0,0,0,0,4,3,1,6,3,3,0,0,-1,-1,-1
"1666","Phil Jones",29,"1992","02","21","2019/2020","Defender","Manchester United",136,90,46,"England",2,1,1,0,0,0,0,0,0,0,0,0,0,0,3,2,1,0,0,-1,-1,-1
"1667","Philip Billing",24,"1996","06","11","2019/2020","Midfielder","AFC Bournemouth",2535,1227,1308,"Denmark",34,17,17,1,1,0,1,0,1,0,0,4,2,2,40,20,20,8,0,238,229,-1
"1668","Philip Foden",20,"2000","05","28","2019/2020","Midfielder","Manchester City",892,532,360,"England",23,13,10,5,4,1,2,1,1,0,0,13,8,5,5,2,3,0,0,22,55,-1
"1669","Philip Heise",29,"1991","06","20","2019/2020","Defender","Norwich City",0,0,0,"Germany",0,0,0,0,0,0,0,0,0,0,0,0,0,0,0,0,0,0,0,-1,-1,-1
"1670","Pierre-Emerick Aubameyang",31,"1989","06","18","2019/2020","Forward","Arsenal",3139,1554,1585,"Gabon",36,18,18,22,13,9,3,2,1,2,0,10,5,5,42,22,20,4,1,7,150,-1
"1671","Pierre-Emile Højbjerg",25,"1995","08","05","2019/2020","Midfielder","Southampton",2751,1440,1311,"Denmark",33,16,17,0,0,0,1,0,1,0,0,8,2,6,47,30,17,5,0,325,239,-1
"1672","Raheem Sterling",26,"1994","12","08","2019/2020","Forward","Manchester City",2659,1214,1445,"England",33,16,17,20,6,14,1,0,1,0,2,13,7,6,29,10,19,5,0,5,249,-1
"1673","Ralf Fährmann",32,"1988","09","27","2019/2020","Goalkeeper","Norwich City",22,0,22,"Germany",1,0,1,0,0,0,0,0,0,0,0,0,0,0,1,0,1,0,0,-1,-1,-1
"1674","Raúl Alonso Jiménez Rodríguez",29,"1991","05","05","2019/2020","Forward","Wolverhampton Wanderers",3252,1644,1608,"Mexico",38,19,19,17,8,9,6,3,3,4,0,13,8,5,34,16,18,3,0,24,73,-1
"1675","Ravel Morrison",28,"1993","02","02","2019/2020","Midfielder","Sheffield United",12,12,0,"England",1,1,0,0,0,0,0,0,0,0,0,0,0,0,0,0,0,0,0,-1,-1,-1
"1676","Reece James",21,"1999","12","08","2019/2020","Defender","Chelsea",1510,760,750,"England",24,11,13,0,0,0,2,2,0,0,0,8,7,1,23,5,18,1,0,260,114,107
"1677","Reiss Nelson",21,"1999","12","10","2019/2020","Forward","Arsenal",627,315,312,"England",17,7,10,1,1,0,0,0,0,0,0,5,3,2,5,3,2,1,0,115,357,-1
"1678","Rhian Brewster",21,"2000","04","01","2019/2020","Forward","Liverpool",0,0,0,"England",0,0,0,0,0,0,0,0,0,0,0,0,0,0,0,0,0,0,0,-1,-1,-1
"1679","Rhu-endly Martina",31,"1989","09","25","2019/2020","Defender","Everton",0,0,0,"Curaçao",0,0,0,0,0,0,0,0,0,0,0,0,0,0,0,0,0,0,0,-1,-1,-1
"1680","Ricardo Domingos Barbosa Pereira",27,"1993","10","06","2019/2020","Defender","Leicester City",2520,1350,1170,"Portugal",28,15,13,3,3,0,2,2,0,0,0,10,5,5,26,15,11,1,0,137,178,33
"1681","Richairo Zivkovic",24,"1996","09","05","2019/2020","Forward","Sheffield United",107,26,81,"Netherlands",5,2,3,0,0,0,0,0,0,0,0,1,1,0,4,0,4,0,0,-1,-1,-1
"1682","Richard Stearman",33,"1987","08","19","2019/2020","Defender","Sheffield United",0,0,0,"England",0,0,0,0,0,0,0,0,0,0,0,0,0,0,0,0,0,0,0,-1,-1,-1
"1683","Richarlison de Andrade",23,"1997","05","10","2019/2020","Forward","Everton",3081,1521,1560,"Brazil",36,18,18,13,7,6,3,1,2,0,0,9,6,3,47,18,29,8,0,41,143,-1
"1684","Riyad Mahrez",30,"1991","02","21","2019/2020","Midfielder","Manchester City",1941,942,999,"Algeria",33,16,17,11,7,4,9,4,5,1,0,14,8,6,12,4,8,0,0,20,8,-1
"1685","Rob Elliot",34,"1986","04","30","2019/2020","Goalkeeper","Newcastle United",0,0,0,"Republic of Ireland",0,0,0,0,0,0,0,0,0,0,0,0,0,0,0,0,0,0,0,-1,-1,-1
"1686","Rob Holding",25,"1995","09","20","2019/2020","Defender","Arsenal",580,224,356,"England",8,3,5,0,0,0,0,0,0,0,0,2,1,1,8,3,5,1,0,256,322,74
"1687","Robbie Brady",29,"1992","01","14","2019/2020","Midfielder","Burnley",448,168,280,"Republic of Ireland",17,10,7,1,1,0,2,2,0,0,0,5,3,2,9,4,5,1,0,92,9,-1
"1688","Robert Kenedy Nunes do Nascimento",25,"1996","02","08","2019/2020","Midfielder","Chelsea",0,0,0,"Brazil",0,0,0,0,0,0,0,0,0,0,0,0,0,0,0,0,0,0,0,-1,-1,-1
"1689","Robert Snodgrass",33,"1987","09","07","2019/2020","Midfielder","West Ham United",1512,786,726,"Scotland",24,13,11,5,4,1,5,4,1,0,0,5,3,2,31,18,13,4,0,53,24,-1
"1690","Roberto",35,"1986","02","10","2019/2020","Goalkeeper","West Ham United",686,360,326,"Spain",8,4,4,0,0,0,0,0,0,0,0,0,0,0,15,9,6,0,0,356,286,156
"1691","Roberto Firmino",29,"1991","10","02","2019/2020","Forward","Liverpool",3003,1462,1541,"Brazil",38,19,19,9,1,8,8,6,2,0,0,15,7,8,26,11,15,0,0,59,34,-1
"1692","Roberto Maximiliano Pereyra",30,"1991","01","07","2019/2020","Forward","Watford",1649,800,849,"Argentina",28,14,14,3,2,1,0,0,0,1,0,8,6,2,26,12,14,4,0,105,362,-1
"1693","Rodri",24,"1996","06","22","2019/2020","Midfielder","Manchester City",2488,1082,1406,"Spain",35,17,18,3,1,2,2,1,1,0,0,16,9,7,24,8,16,8,0,146,171,-1
"1694","Romain Saïss",31,"1990","03","26","2019/2020","Midfielder","Wolverhampton Wanderers",2706,1260,1446,"Morocco",33,14,19,2,0,2,1,1,0,0,0,12,7,5,29,12,17,12,1,186,257,-1
"1695","Ross Barkley",27,"1993","12","05","2019/2020","Midfielder","Chelsea",1104,640,464,"England",21,11,10,1,1,0,4,4,0,0,0,7,7,0,13,3,10,0,0,177,18,-1
"1696","Rúben Diogo Da Silva Neves",24,"1997","03","13","2019/2020","Midfielder","Wolverhampton Wanderers",3060,1539,1521,"Portugal",38,19,19,2,2,0,2,2,0,0,0,13,8,5,31,15,16,9,0,211,203,-1
"1697","Rúben Gonçalo Silva Nascimento Vinagre",22,"1999","04","09","2019/2020","Defender","Wolverhampton Wanderers",644,122,522,"Portugal",16,4,12,0,0,0,0,0,0,0,0,4,2,2,6,0,6,1,0,374,342,19
"1698","Ruben Loftus-Cheek",25,"1996","01","23","2019/2020","Midfielder","Chelsea",205,86,119,"England",7,3,4,0,0,0,1,0,1,0,0,3,3,0,3,0,3,0,0,-1,-1,-1
"1699","Rui Pedro dos Santos Patrício",33,"1988","02","15","2019/2020","Goalkeeper","Wolverhampton Wanderers",3420,1710,1710,"Portugal",38,19,19,0,0,0,0,0,0,0,0,13,8,5,35,16,19,0,0,370,386,30
"1700","Ryan Bennett",31,"1990","03","06","2019/2020","Defender","Leicester City",935,338,597,"England",16,8,8,0,0,0,0,0,0,0,0,5,3,2,16,2,14,2,0,371,384,124
"1701","Ryan Bertrand",31,"1989","08","05","2019/2020","Defender","Southampton",2743,1303,1440,"England",32,16,16,1,1,0,1,0,1,0,0,7,3,4,41,20,21,4,1,242,243,103
"1702","Ryan Fraser",27,"1994","02","24","2019/2020","Midfielder","AFC Bournemouth",2062,1113,949,"Scotland",28,13,15,1,1,0,4,2,2,0,0,4,2,2,33,17,16,2,0,237,78,-1
"1703","Ryan Fredericks",28,"1992","10","10","2019/2020","Midfielder","West Ham United",2237,1097,1140,"England",27,14,13,0,0,0,3,2,1,0,0,7,3,4,37,22,15,7,0,352,118,-1
"1704","Ryan Giles",21,"2000","01","26","2019/2020","Midfielder","Wolverhampton Wanderers",0,0,0,"England",0,0,0,0,0,0,0,0,0,0,0,0,0,0,0,0,0,0,0,-1,-1,-1
"1705","Ryan Sessegnon",20,"2000","05","18","2019/2020","Defender","Tottenham Hotspur",341,161,180,"England",6,3,3,0,0,0,0,0,0,0,0,1,1,0,5,2,3,0,0,264,329,94
"1706","Sadio Mané",29,"1992","04","10","2019/2020","Forward","Liverpool",2755,1505,1250,"Senegal",35,18,17,18,11,7,7,4,3,0,0,12,6,6,27,14,13,3,0,13,41,-1
"1707","Sam Byram",27,"1993","09","16","2019/2020","Defender","Norwich City",1293,573,720,"England",17,9,8,0,0,0,0,0,0,0,0,3,1,2,22,10,12,4,0,351,268,122
"1708","Sam Surridge",22,"1998","07","28","2019/2020","Forward","AFC Bournemouth",23,23,0,"England",4,3,1,0,0,0,0,0,0,0,0,0,0,0,0,0,0,0,0,-1,-1,-1
"1709","Sam Woods",22,"1998","09","11","2019/2020","Defender","Crystal Palace",0,0,0,"England",0,0,0,0,0,0,0,0,0,0,0,0,0,0,0,0,0,0,0,-1,-1,-1
"1710","Sander Berge",23,"1998","02","14","2019/2020","Midfielder","Sheffield United",948,475,473,"Norway",14,7,7,1,1,0,1,1,0,0,0,5,3,2,10,3,7,0,0,165,142,-1
"1711","Scott Carson",35,"1985","09","03","2019/2020","Goalkeeper","Manchester City",0,0,0,"England",0,0,0,0,0,0,0,0,0,0,0,0,0,0,0,0,0,0,0,-1,-1,-1
"1712","Scott Dann",34,"1987","02","14","2019/2020","Defender","Crystal Palace",1265,727,538,"England",16,9,7,0,0,0,1,0,1,0,0,6,3,3,14,8,6,0,0,331,187,40
"1713","Scott McTominay",24,"1996","12","08","2019/2020","Midfielder","Manchester United",1772,800,972,"England",27,13,14,4,3,1,1,0,1,0,0,9,5,4,19,7,12,2,0,91,219,-1
"1714","Sead Kolašinac",27,"1993","06","20","2019/2020","Defender","Arsenal",1699,724,975,"Bosnia and Herzegovina",26,14,12,0,0,0,2,0,2,0,0,5,3,2,24,10,14,4,0,275,127,82
"1715","Séamus Coleman",32,"1988","10","11","2019/2020","Defender","Everton",1839,1026,813,"Republic of Ireland",27,15,12,0,0,0,1,1,0,0,0,7,4,3,24,12,12,5,1,340,213,60
"1716","Sean Longstaff",23,"1997","10","30","2019/2020","Midfielder","Newcastle United",1372,502,870,"England",23,11,12,1,0,1,1,0,1,0,0,6,4,2,23,6,17,3,1,195,185,-1
"1717","Sebastian Prödl",33,"1987","06","21","2019/2020","Defender","Watford",57,57,0,"Austria",1,1,0,0,0,0,0,0,0,0,0,1,1,0,0,0,0,0,0,-1,-1,-1
"1718","Sébastien Haller",26,"1994","06","22","2019/2020","Forward","West Ham United",2262,1245,1017,"France",32,17,15,7,4,3,1,0,1,0,0,7,3,4,39,22,17,1,0,57,233,-1
"1719","Serge Aurier",28,"1992","12","24","2019/2020","Defender","Tottenham Hotspur",2706,1449,1257,"Côte d'Ivoire",33,17,16,1,1,0,5,4,1,0,0,8,6,2,30,13,17,4,1,250,77,38
"1720","Sergio Aguero",32,"1988","06","02","2019/2020","Forward","Manchester City",1456,833,623,"Argentina",24,13,11,16,8,8,3,2,1,2,1,10,7,3,15,6,9,1,0,1,60,-1
"1721","Sergio Germán Romero",34,"1987","02","22","2019/2020","Goalkeeper","Manchester United",0,0,0,"Argentina",0,0,0,0,0,0,0,0,0,0,0,0,0,0,0,0,0,0,0,-1,-1,-1
"1722","Shane Duffy",29,"1992","01","01","2019/2020","Defender","Brighton & Hove Albion",1231,688,543,"Republic of Ireland",19,9,10,1,1,0,0,0,0,0,0,6,3,3,15,8,7,2,0,187,349,50
"1723","Shane Long",34,"1987","01","22","2019/2020","Forward","Southampton",1397,711,686,"Republic of Ireland",26,13,13,2,2,0,2,1,1,0,0,6,3,3,19,10,9,0,0,125,104,-1
"1724","Shkodran Mustafi",29,"1992","04","17","2019/2020","Defender","Arsenal",1206,473,733,"Germany",15,6,9,0,0,0,1,0,1,0,0,5,2,3,15,6,9,2,0,271,175,51
"1725","Simon Francis",36,"1985","02","16","2019/2020","Defender","AFC Bournemouth",965,488,477,"England",15,7,8,0,0,0,0,0,0,0,0,1,0,1,20,10,10,5,1,270,297,154
"1726","Simon Moore",30,"1990","05","19","2019/2020","Goalkeeper","Sheffield United",180,90,90,"England",2,1,1,0,0,0,0,0,0,0,0,0,0,0,6,3,3,0,0,-1,-1,-1
"1727","Sofiane Boufal",27,"1993","09","17","2019/2020","Midfielder","Southampton",758,451,307,"Morocco",20,9,11,0,0,0,2,0,2,0,0,4,0,4,14,8,6,2,0,327,37,-1
"1728","Sokratis Papastathopoulos",32,"1988","06","09","2019/2020","Defender","Arsenal",1697,990,707,"Greece",19,11,8,2,2,0,0,0,0,0,0,4,3,1,25,15,10,6,0,150,374,97
"1729","Solomon March",26,"1994","07","20","2019/2020","Midfielder","Brighton & Hove Albion",1143,566,577,"England",19,9,10,0,0,0,1,1,0,0,0,4,1,3,14,6,8,2,0,409,164,-1
"1730","Stephen Henderson",32,"1988","05","02","2019/2020","Goalkeeper","Crystal Palace",0,0,0,"Republic of Ireland",0,0,0,0,0,0,0,0,0,0,0,0,0,0,0,0,0,0,0,-1,-1,-1
"1731","Steve Cook",30,"1991","04","19","2019/2020","Defender","AFC Bournemouth",2430,1210,1220,"England",29,14,15,1,1,0,0,0,0,0,0,3,2,1,45,21,24,7,1,233,395,136
"1732","Steven Alzate",22,"1998","09","08","2019/2020","Midfielder","Brighton & Hove Albion",1183,581,602,"England",19,9,10,0,0,0,0,0,0,0,0,4,3,1,17,6,11,1,0,306,266,-1
"1733","Steven Bergwijn",23,"1997","10","08","2019/2020","Forward","Tottenham Hotspur",704,281,423,"Netherlands",14,7,7,3,3,0,1,0,1,0,0,5,4,1,9,3,6,2,0,43,107,-1
"1734","Stuart Armstrong",29,"1992","03","30","2019/2020","Midfielder","Southampton",1716,744,972,"Scotland",30,15,15,5,1,4,3,1,2,0,0,9,3,6,23,11,12,4,0,64,82,-1
"1735","Sung-Yeung Ki",32,"1989","01","24","2019/2020","Midfielder","Newcastle United",136,17,119,"South Korea",3,1,2,0,0,0,0,0,0,0,0,1,1,0,5,0,5,0,0,-1,-1,-1
"1736","Tahith Chong",21,"1999","12","04","2019/2020","Forward","Manchester United",34,30,4,"Netherlands",3,2,1,0,0,0,0,0,0,0,0,2,2,0,0,0,0,0,0,-1,-1,-1
"1737","Takumi Minamino",26,"1995","01","16","2019/2020","Forward","Liverpool",243,28,215,"Japan",10,3,7,0,0,0,0,0,0,0,0,3,2,1,2,0,2,0,0,-1,-1,-1
"1738","Tammy Abraham",23,"1997","10","02","2019/2020","Forward","Chelsea",2221,956,1265,"England",34,16,18,15,5,10,3,1,2,0,0,8,7,1,34,11,23,2,0,11,119,-1
"1739","Tanguy Ndombele",24,"1996","12","28","2019/2020","Midfielder","Tottenham Hotspur",1010,381,629,"France",21,9,12,2,2,0,2,1,1,0,0,3,2,1,17,3,14,3,0,96,67,-1
"1740","Tariq Lamptey",20,"2000","09","30","2019/2020","Midfielder","Brighton & Hove Albion",622,253,369,"England",9,4,5,0,0,0,1,1,0,0,0,3,1,2,8,6,2,2,0,301,93,-1
"1741","Taylor Harwood-Bellis",19,"2002","01","30","2019/2020","Defender","Manchester City",0,0,0,"England",0,0,0,0,0,0,0,0,0,0,0,0,0,0,0,0,0,0,0,-1,-1,-1
"1742","Taylor Perry",19,"2001","07","15","2019/2020","Midfielder","Wolverhampton Wanderers",0,0,0,"England",0,0,0,0,0,0,0,0,0,0,0,0,0,0,0,0,0,0,0,-1,-1,-1
"1743","Teemu Pukki",31,"1990","03","29","2019/2020","Forward","Norwich City",2894,1424,1470,"Finland",36,18,18,11,7,4,3,2,1,2,0,5,2,3,57,30,27,3,0,46,149,-1
"1744","Theo Walcott",32,"1989","03","16","2019/2020","Forward","Everton",1295,696,599,"England",25,14,11,2,1,1,3,3,0,0,0,5,4,1,18,8,10,1,0,120,47,-1
"1745","Thomas David Allan",21,"1999","09","23","2019/2020","Forward","Newcastle United",0,0,0,"England",0,0,0,0,0,0,0,0,0,0,0,0,0,0,0,0,0,0,0,-1,-1,-1
"1746","Thomas Doyle",19,"2001","10","17","2019/2020","Midfielder","Manchester City",15,15,0,"England",1,1,0,0,0,0,0,0,0,0,0,1,1,0,0,0,0,0,0,-1,-1,-1
"1747","Tim Krul",33,"1988","04","03","2019/2020","Goalkeeper","Norwich City",3240,1620,1620,"Netherlands",36,18,18,0,0,0,0,0,0,0,0,5,2,3,66,31,35,4,0,344,317,152
"1748","Timm Klose",32,"1988","05","09","2019/2020","Defender","Norwich City",586,406,180,"Switzerland",7,5,2,0,0,0,0,0,0,0,0,0,0,0,13,10,3,0,0,278,339,160
"1749","Timothy Fosu-Mensah",23,"1998","01","02","2019/2020","Defender","Manchester United",136,46,90,"Netherlands",3,1,2,0,0,0,0,0,0,0,0,2,0,2,1,1,0,1,0,-1,-1,-1
"1750","Toby Alderweireld",32,"1989","03","02","2019/2020","Defender","Tottenham Hotspur",2958,1350,1608,"Belgium",33,15,18,2,1,1,2,2,0,0,0,7,5,2,36,11,25,7,0,212,198,49
"1751","Todd Cantwell",23,"1998","02","27","2019/2020","Midfielder","Norwich City",2504,1127,1377,"England",37,19,18,6,5,1,2,2,0,0,0,5,2,3,51,20,31,6,0,85,173,-1
"1752","Tom Cleverley",31,"1989","08","12","2019/2020","Midfielder","Watford",967,415,552,"England",18,8,10,1,1,0,0,0,0,0,0,2,2,0,24,9,15,2,0,166,361,-1
"1753","Tom Davies",22,"1998","06","30","2019/2020","Midfielder","Everton",2027,953,1074,"England",30,16,14,1,0,1,0,0,0,0,0,8,5,3,29,8,21,8,0,231,372,-1
"1754","Tom Heaton",35,"1986","04","15","2019/2020","Goalkeeper","Aston Villa",1795,900,895,"England",20,10,10,0,0,0,0,0,0,0,0,4,4,0,33,13,20,0,0,418,279,134
"1755","Tom Trybull",28,"1993","03","09","2019/2020","Midfielder","Norwich City",1138,511,627,"Germany",16,7,9,0,0,0,0,0,0,0,0,2,0,2,25,12,13,2,0,349,264,-1
"1756","Tomáš Souček",26,"1995","02","27","2019/2020","Midfielder","West Ham United",1041,535,506,"Czech Republic",13,6,7,3,2,1,0,0,0,0,0,1,0,1,18,10,8,0,0,67,305,-1
"1757","Trent Alexander-Arnold",22,"1998","10","07","2019/2020","Defender","Liverpool",3176,1618,1558,"England",38,19,19,4,2,2,13,9,4,0,0,15,7,8,31,15,16,5,0,139,11,24
"1758","Troy Deeney",32,"1988","06","29","2019/2020","Forward","Watford",2234,1176,1058,"England",27,14,13,10,6,4,2,2,0,5,1,6,5,1,36,17,19,3,0,35,167,-1
"1759","Troy Parrott",19,"2002","02","04","2019/2020","Forward","Tottenham Hotspur",5,5,0,"Republic of Ireland",2,2,0,0,0,0,0,0,0,0,0,1,1,0,0,0,0,0,0,-1,-1,-1
"1760","Tudor Cristian Băluţă",22,"1999","03","27","2019/2020","Defender","Brighton & Hove Albion",0,0,0,"Romania",0,0,0,0,0,0,0,0,0,0,0,0,0,0,0,0,0,0,0,-1,-1,-1
"1761","Tyreece John-Jules",20,"2001","02","14","2019/2020","Forward","Arsenal",0,0,0,"England",0,0,0,0,0,0,0,0,0,0,0,0,0,0,0,0,0,0,0,-1,-1,-1
"1762","Tyrick Mitchell",21,"1999","09","01","2019/2020","Defender","Crystal Palace",193,96,97,"England",4,2,2,0,0,0,0,0,0,0,0,0,0,0,3,1,2,1,0,-1,-1,-1
"1763","Tyrone Mings",28,"1993","03","13","2019/2020","Defender","Aston Villa",2903,1373,1530,"England",33,16,17,2,1,1,2,1,1,0,0,6,6,0,50,20,30,7,0,209,207,125
"1764","Valentino Lazaro",25,"1996","03","24","2019/2020","Midfielder","Newcastle United",474,191,283,"Austria",13,6,7,1,0,1,0,0,0,0,0,4,2,2,11,4,7,1,1,95,304,-1
"1765","Vicente Guaita",34,"1987","01","10","2019/2020","Goalkeeper","Crystal Palace",3150,1620,1530,"Spain",35,18,17,0,0,0,0,0,0,0,0,10,6,4,40,17,23,1,0,330,352,57
"1766","Víctor Camarasa",26,"1994","05","28","2019/2020","Midfielder","Crystal Palace",5,0,5,"Spain",1,0,1,0,0,0,0,0,0,0,0,0,0,0,0,0,0,0,0,-1,-1,-1
"1767","Victor Nilsson Lindelöf",26,"1994","07","17","2019/2020","Defender","Manchester United",3094,1576,1518,"Sweden",35,18,17,1,1,0,0,0,0,0,0,12,7,5,28,12,16,6,0,243,340,15
"1768","Victor Wanyama",29,"1991","06","25","2019/2020","Midfielder","Tottenham Hotspur",23,0,23,"Kenya",2,1,1,0,0,0,0,0,0,0,0,0,0,0,2,0,2,1,0,-1,-1,-1
"1769","Virgil van Dijk",29,"1991","07","08","2019/2020","Defender","Liverpool",3420,1710,1710,"Netherlands",38,19,19,5,4,1,1,1,0,0,0,15,7,8,33,16,17,1,0,123,258,23
"1770","Wayne Hennessey",34,"1987","01","24","2019/2020","Goalkeeper","Crystal Palace",270,90,180,"Wales",3,1,2,0,0,0,0,0,0,0,0,0,0,0,8,2,6,0,0,-1,-1,-1
"1771","Wes Morgan",37,"1984","01","21","2019/2020","Defender","Leicester City",429,198,231,"Jamaica",11,4,7,0,0,0,0,0,0,0,0,5,1,4,5,1,4,0,0,392,396,46
"1772","Wesley Moraes Ferreira da Silva",24,"1996","11","26","2019/2020","Forward","Aston Villa",1790,880,910,"Brazil",21,10,11,5,1,4,1,0,1,0,1,4,4,0,31,12,19,3,0,72,208,-1
"1773","Wilfredo Daniel Caballero",39,"1981","09","28","2019/2020","Goalkeeper","Chelsea",450,270,180,"Argentina",5,3,2,0,0,0,0,0,0,0,0,1,1,0,7,3,4,0,0,276,411,110
"1774","Wilfried Zaha",28,"1992","11","10","2019/2020","Midfielder","Crystal Palace",3280,1645,1635,"Côte d'Ivoire",38,19,19,4,3,1,3,1,2,0,0,10,6,4,44,19,25,5,0,142,163,-1
"1775","Will Ferry",19,"2001","12","07","2019/2020","Midfielder","Southampton",0,0,0,"England",0,0,0,0,0,0,0,0,0,0,0,0,0,0,0,0,0,0,0,-1,-1,-1
"1776","Will Hughes",26,"1995","04","17","2019/2020","Midfielder","Watford",2263,1025,1238,"England",30,14,16,1,0,1,1,1,0,0,0,5,4,1,43,17,26,9,0,236,226,-1
"1777","William Smallbone",21,"2000","02","21","2019/2020","Midfielder","Southampton",392,218,174,"England",9,4,5,0,0,0,2,1,1,0,0,3,2,1,4,1,3,0,0,303,6,-1
"1778","Willian",32,"1988","08","09","2019/2020","Forward","Chelsea",2604,1274,1330,"Brazil",36,18,18,9,4,5,7,2,5,4,0,8,7,1,34,11,23,4,0,51,36,-1
"1779","Willy Boly",30,"1991","02","03","2019/2020","Defender","Wolverhampton Wanderers",1980,990,990,"France",22,11,11,0,0,0,1,0,1,0,0,12,7,5,13,5,8,3,1,372,216,3
"1780","Winston Reid",32,"1988","07","03","2019/2020","Defender","West Ham United",0,0,0,"New Zealand",0,0,0,0,0,0,0,0,0,0,0,0,0,0,0,0,0,0,0,-1,-1,-1
"1781","Xherdan Shaqiri",29,"1991","10","10","2019/2020","Midfielder","Liverpool",181,166,15,"Switzerland",7,3,4,1,1,0,0,0,0,0,0,4,1,3,2,2,0,0,0,-1,-1,-1
"1782","Yann Valery",22,"1999","02","22","2019/2020","Defender","Southampton",784,400,384,"France",11,6,5,0,0,0,0,0,0,0,0,2,0,2,20,15,5,1,0,324,359,167
"1783","Yerry Fernando Mina González",26,"1994","09","23","2019/2020","Defender","Everton",2282,1107,1175,"Colombia",29,14,15,2,0,2,1,0,1,0,0,6,5,1,31,11,20,3,0,180,236,67
"1784","Yoshinori Muto",28,"1992","07","15","2019/2020","Forward","Newcastle United",207,98,109,"Japan",8,2,6,0,0,0,0,0,0,0,0,1,0,1,6,3,3,0,0,-1,-1,-1
"1785","Youri Tielemans",23,"1997","05","07","2019/2020","Midfielder","Leicester City",2834,1433,1401,"Belgium",37,19,18,3,2,1,6,5,1,0,0,13,8,5,34,15,19,2,0,159,64,-1
"1786","Yves Bissouma",24,"1996","08","30","2019/2020","Midfielder","Brighton & Hove Albion",1263,636,627,"Mali",22,11,11,1,0,1,0,0,0,0,0,7,3,4,18,13,5,4,0,188,265,-1
"1787","Zechariah Medley",20,"2000","07","07","2019/2020","Defender","Arsenal",0,0,0,"England",0,0,0,0,0,0,0,0,0,0,0,0,0,0,0,0,0,0,0,-1,-1,-1
"1788","Ørjan Håskjold Nyland",30,"1990","09","10","2019/2020","Goalkeeper","Aston Villa",537,360,177,"Norway",7,4,3,0,0,0,0,0,0,0,0,1,1,0,12,9,3,0,0,311,331,161
"1789","Łukasz Fabiański",36,"1985","04","18","2019/2020","Goalkeeper","West Ham United",2119,1170,949,"Poland",25,13,12,0,0,0,0,0,0,0,0,5,3,2,33,19,14,1,0,341,271,109
"1790","Aaron Anthony Connolly",21,"2000","01","28","2020/2021","Forward","Brighton & Hove Albion",790,397,393,"Republic of Ireland",17,8,9,2,1,1,1,0,1,0,0,4,2,2,17,10,7,0,0,74,126,-1
"1791","Aaron Cresswell",31,"1989","12","15","2020/2021","Defender","West Ham United",3172,1552,1620,"England",36,18,18,0,0,0,8,2,6,0,0,11,6,5,40,19,21,3,0,317,32,58
"1792","Aaron Ramsdale",23,"1998","05","14","2020/2021","Goalkeeper","Sheffield United",3420,1710,1710,"England",38,19,19,0,0,0,0,0,0,0,0,5,4,1,61,26,35,1,0,394,403,131
"1793","Aaron Wan-Bissaka",23,"1997","11","26","2020/2021","Midfielder","Manchester United",3060,1530,1530,"England",34,17,17,2,1,1,4,3,1,0,0,13,6,7,33,21,12,3,0,201,110,-1
"1794","Abdoulaye Doucouré",28,"1993","01","01","2020/2021","Midfielder","Everton",2452,1211,1241,"France",29,14,15,2,0,2,3,1,2,0,0,9,3,6,33,17,16,6,0,184,130,-1
"1795","Aboubakar Kamara",26,"1995","03","07","2020/2021","Forward","Fulham",312,208,104,"France",11,7,4,0,0,0,0,0,0,0,0,1,1,0,9,5,4,2,1,343,334,-1
"1796","Adam David Lallana",33,"1988","05","10","2020/2021","Midfielder","Brighton & Hove Albion",1588,784,804,"England",30,15,15,1,1,0,1,0,1,0,0,9,5,4,17,7,10,0,0,202,183,-1
"1797","Adam Webster",26,"1995","01","04","2020/2021","Defender","Brighton & Hove Albion",2595,1260,1335,"England",29,14,15,1,1,0,0,0,0,0,0,9,4,5,33,17,16,4,0,263,389,61
"1798","Adama Traoré Diarra",25,"1996","01","25","2020/2021","Midfielder","Wolverhampton Wanderers",2643,1209,1434,"Spain",37,18,19,2,1,1,2,2,0,0,0,10,5,5,36,18,18,4,0,179,169,-1
"1799","Ademipo Odubeko",19,"2002","10","21","2020/2021","Midfielder","West Ham United",0,0,0,"England",0,0,0,0,0,0,0,0,0,0,0,0,0,0,0,0,0,0,0,-1,-1,-1
"1800","Ademola Lookman",24,"1997","10","20","2020/2021","Forward","Fulham",2756,1412,1344,"England",34,16,18,4,2,2,4,3,1,0,1,9,5,4,32,20,12,5,0,127,105,-1
"1801","Adrian Bernabe Garcia",20,"2001","05","26","2020/2021","Midfielder","Manchester City",0,0,0,"Spain",0,0,0,0,0,0,0,0,0,0,0,0,0,0,0,0,0,0,0,-1,-1,-1
"1802","Adrián San Miguel del Castillo",34,"1987","01","03","2020/2021","Goalkeeper","Liverpool",270,0,270,"Spain",3,0,3,0,0,0,0,0,0,0,0,1,0,1,9,0,9,0,0,-1,-1,-1
"1803","Ahmed Eissa El Mohamady Abdel Fattah",34,"1987","09","09","2020/2021","Midfielder","Aston Villa",833,442,391,"Egypt",14,8,6,0,0,0,0,0,0,0,0,6,4,2,8,4,4,2,0,387,301,-1
"1804","Ahmed Hegazi",30,"1991","01","25","2020/2021","Defender","West Bromwich Albion",90,90,0,"Egypt",1,1,0,0,0,0,0,0,0,0,0,1,1,0,0,0,0,0,0,-1,-1,-1
"1805","Ainsley Maitland-Niles",24,"1997","08","29","2020/2021","Midfielder","West Bromwich Albion",1718,788,930,"England",26,12,14,0,0,0,0,0,0,0,0,10,4,6,22,5,17,2,0,348,339,-1
"1806","Aleksandar Mitrović",27,"1994","09","16","2020/2021","Forward","Fulham",1389,727,662,"Serbia",27,15,12,3,0,3,3,2,1,1,1,7,4,3,22,10,12,3,0,93,60,-1
"1807","Alex Iwobi",25,"1996","05","03","2020/2021","Forward","Everton",1541,727,814,"Nigeria",30,14,16,1,0,1,2,1,1,0,0,8,2,6,19,8,11,0,0,200,123,-1
"1808","Alex McCarthy",31,"1989","12","03","2020/2021","Goalkeeper","Southampton",2700,1350,1350,"England",30,15,15,0,0,0,0,0,0,0,0,7,5,2,49,18,31,2,0,354,344,133
"1809","Alex Nicolao Telles",28,"1992","12","15","2020/2021","Defender","Manchester United",692,338,354,"Brazil",9,5,4,0,0,0,2,1,1,0,0,2,2,0,11,5,6,0,0,311,22,105
"1810","Alex Oxlade-Chamberlain",28,"1993","08","15","2020/2021","Midfielder","Liverpool",243,121,122,"England",13,6,7,1,0,1,1,0,1,0,0,5,2,3,6,0,6,0,0,-1,-1,-1
"1811","Alexandre Jankewitz",19,"2001","12","25","2020/2021","Midfielder","Southampton",3,1,2,"Switzerland",2,1,1,0,0,0,0,0,0,0,0,0,0,0,0,0,0,1,1,-1,-1,-1
"1812","Alexandre Lacazette",30,"1991","05","28","2020/2021","Forward","Arsenal",1930,959,971,"France",31,15,16,13,3,10,2,0,2,3,0,10,4,6,21,10,11,3,0,8,141,-1
"1813","Alexis Mac Allister",22,"1998","12","24","2020/2021","Midfielder","Brighton & Hove Albion",1116,587,529,"Argentina",21,10,11,1,0,1,1,0,1,0,0,7,5,2,13,6,7,1,0,169,156,-1
"1814","Alfie Devine",17,"2004","08","01","2020/2021","Midfielder","Tottenham Hotspur",0,0,0,"England",0,0,0,0,0,0,0,0,0,0,0,0,0,0,0,0,0,0,0,-1,-1,-1
"1815","Alireza Jahanbakhsh",28,"1993","08","11","2020/2021","Forward","Brighton & Hove Albion",521,325,196,"Iran",21,13,8,0,0,0,1,1,0,0,0,5,3,2,7,4,3,3,0,392,79,-1
"1816","Alisson Becker",29,"1992","10","02","2020/2021","Goalkeeper","Liverpool",2970,1530,1440,"Brazil",33,17,16,1,0,1,0,0,0,0,0,10,4,6,30,18,12,1,0,257,350,23
"1817","Allan",30,"1991","01","08","2020/2021","Midfielder","Everton",2052,990,1062,"Brazil",24,11,13,0,0,0,0,0,0,0,0,9,3,6,29,14,15,6,0,402,400,-1
"1818","Allan Saint-Maximin",24,"1997","03","12","2020/2021","Midfielder","Newcastle United",1568,861,707,"France",25,14,11,3,1,2,4,3,1,0,0,4,1,3,24,15,9,0,0,101,31,-1
"1819","Allan Tchaptchet",19,"2001","12","21","2020/2021","Defender","Southampton",12,0,12,"France",1,0,1,0,0,0,0,0,0,0,0,0,0,0,1,0,1,0,0,-1,-1,-1
"1820","Alphonse Areola",28,"1993","02","27","2020/2021","Goalkeeper","Fulham",3240,1530,1710,"France",36,17,19,0,0,0,0,0,0,0,0,9,5,4,45,22,23,2,0,345,335,82
"1821","Amad Diallo Traoré",19,"2002","07","11","2020/2021","Forward","Manchester United",167,85,82,"Côte d'Ivoire",3,2,1,0,0,0,1,1,0,0,0,0,0,0,3,2,1,0,0,-1,-1,-1
"1822","Andi Zeqiri",22,"1999","06","22","2020/2021","Forward","Brighton & Hove Albion",163,101,62,"Switzerland",9,5,4,0,0,0,0,0,0,0,0,2,1,1,1,1,0,0,0,-1,-1,-1
"1823","André Filipe Tavares Gomes",28,"1993","07","30","2020/2021","Midfielder","Everton",1568,718,850,"Portugal",28,14,14,0,0,0,1,0,1,0,0,10,3,7,20,12,8,3,0,403,190,-1
"1824","André-Frank Zambo Anguissa",25,"1995","11","16","2020/2021","Midfielder","Fulham",2587,1245,1342,"Cameroon",36,19,17,0,0,0,3,1,2,0,0,8,5,3,37,19,18,6,0,344,134,-1
"1825","Andreas Christensen",25,"1996","04","10","2020/2021","Defender","Chelsea",1371,732,639,"Denmark",17,9,8,0,0,0,0,0,0,0,0,9,5,4,13,7,6,3,1,391,368,17
"1826","Andreas Söndergaard",20,"2001","01","17","2020/2021","Goalkeeper","Wolverhampton Wanderers",0,0,0,"Denmark",0,0,0,0,0,0,0,0,0,0,0,0,0,0,0,0,0,0,0,-1,-1,-1
"1827","Andrew Lonergan",38,"1983","10","19","2020/2021","Goalkeeper","West Bromwich Albion",0,0,0,"England",0,0,0,0,0,0,0,0,0,0,0,0,0,0,0,0,0,0,0,-1,-1,-1
"1828","Andrew Robertson",27,"1994","03","11","2020/2021","Defender","Liverpool",3386,1705,1681,"Scotland",38,19,19,1,1,0,7,3,4,0,0,12,5,7,40,19,21,2,0,248,59,43
"1829","Andriy Yarmolenko",32,"1989","10","23","2020/2021","Forward","West Ham United",362,196,166,"Ukraine",15,8,7,0,0,0,1,1,0,0,0,4,1,3,6,4,2,3,0,319,25,-1
"1830","Andros Townsend",30,"1991","07","16","2020/2021","Midfielder","Crystal Palace",2258,1156,1102,"England",34,18,16,1,0,1,5,4,1,0,0,8,6,2,33,13,20,0,0,232,52,-1
"1831","Andy Carroll",32,"1989","01","06","2020/2021","Forward","Newcastle United",382,84,298,"England",18,8,10,1,1,0,0,0,0,0,0,3,1,2,7,2,5,1,0,69,316,-1
"1832","Angelo Ogbonna",33,"1988","05","23","2020/2021","Defender","West Ham United",2493,1143,1350,"Italy",28,13,15,3,1,2,0,0,0,0,0,9,4,5,33,15,18,5,0,146,305,72
"1833","Anthony Driscoll-Glennon",21,"1999","11","26","2020/2021","Defender","Burnley",0,0,0,"England",0,0,0,0,0,0,0,0,0,0,0,0,0,0,0,0,0,0,0,-1,-1,-1
"1834","Anthony Elanga",0,"1970","01","01","2020/2021","Forward","Manchester United",156,66,90,"England",2,1,1,1,0,1,0,0,0,0,0,0,0,0,2,1,1,0,0,-1,-1,-1
"1835","Anthony Gomez Mancini",0,"1970","01","01","2020/2021","Midfielder","Burnley",0,0,0,"France",0,0,0,0,0,0,0,0,0,0,0,0,0,0,0,0,0,0,0,-1,-1,-1
"1836","Anthony Gordon",20,"2001","02","24","2020/2021","Midfielder","Everton",87,0,87,"England",3,0,3,0,0,0,0,0,0,0,0,2,0,2,0,0,0,0,0,-1,-1,-1
"1837","Anthony Knockaert",29,"1991","11","20","2020/2021","Midfielder","Fulham",0,0,0,"France",0,0,0,0,0,0,0,0,0,0,0,0,0,0,0,0,0,0,0,-1,-1,-1
"1838","Anthony Martial",25,"1995","12","05","2020/2021","Forward","Manchester United",1487,634,853,"France",22,10,12,4,3,1,3,2,1,0,0,9,4,5,19,11,8,1,1,70,64,-1
"1839","Antonee Robinson",24,"1997","08","08","2020/2021","Defender","Fulham",2161,1198,963,"England",28,15,13,0,0,0,0,0,0,0,0,7,5,2,24,13,11,5,1,290,278,36
"1840","Antonio Rüdiger",28,"1993","03","03","2020/2021","Defender","Chelsea",1710,630,1080,"Germany",19,7,12,1,1,0,0,0,0,0,0,11,5,6,10,2,8,0,0,220,371,2
"1841","Antwoine Hackford",17,"2004","03","20","2020/2021","Forward","Sheffield United",10,0,10,"England",1,0,1,0,0,0,0,0,0,0,0,0,0,0,0,0,0,0,0,-1,-1,-1
"1842","Anwar El Ghazi",26,"1995","05","03","2020/2021","Forward","Aston Villa",1614,759,855,"Netherlands",28,13,15,10,3,7,0,0,0,4,0,8,4,4,19,9,10,2,0,12,267,-1
"1843","Arthur Masuaku",28,"1993","11","07","2020/2021","Defender","West Ham United",1011,496,515,"France",12,6,6,0,0,0,2,1,1,0,0,4,2,2,14,6,8,2,0,374,67,83
"1844","Ashley Barnes",32,"1989","10","30","2020/2021","Forward","Burnley",1336,635,701,"England",22,10,12,3,2,1,0,0,0,1,0,8,1,7,19,9,10,4,0,85,287,-1
"1845","Ashley Westwood",31,"1990","04","01","2020/2021","Midfielder","Burnley",3411,1701,1710,"England",38,19,19,3,0,3,3,2,1,0,0,11,3,8,54,27,27,7,0,173,165,-1
"1846","Axel Tuanzebe",23,"1997","11","14","2020/2021","Defender","Manchester United",399,262,137,"England",9,5,4,0,0,0,0,0,0,0,0,1,0,1,7,5,2,2,0,296,253,123
"1847","Aymeric Laporte",27,"1994","05","27","2020/2021","Defender","Manchester City",1342,540,802,"France",16,6,10,0,0,0,0,0,0,0,0,8,2,6,9,5,4,1,0,304,273,4
"1848","Ayoze Perez",28,"1993","07","29","2020/2021","Forward","Leicester City",1332,695,637,"Spain",25,16,9,2,1,1,1,1,0,0,0,8,5,3,19,12,7,2,0,120,182,-1
"1849","Bailey Peacock-Farrell",25,"1996","10","29","2020/2021","Goalkeeper","Burnley",360,180,180,"England",4,2,2,0,0,0,0,0,0,0,0,0,0,0,13,6,7,0,0,382,385,163
"1850","Bakayo Sako",0,"1970","01","01","2020/2021","Midfielder","Arsenal",2562,1383,1179,"England",32,17,15,5,3,2,3,1,2,0,0,9,3,6,31,17,14,1,0,99,129,-1
"1851","Ben Chilwell",24,"1996","12","21","2020/2021","Defender","Chelsea",2290,1066,1224,"England",27,13,14,3,2,1,5,3,2,0,0,13,6,7,21,10,11,3,0,135,53,16
"1852","Ben Davies",26,"1995","08","11","2020/2021","Defender","Liverpool",0,0,0,"England",0,0,0,0,0,0,0,0,0,0,0,0,0,0,0,0,0,0,0,-1,-1,-1
"1853","Ben Davies",28,"1993","04","24","2020/2021","Defender","Tottenham Hotspur",1340,563,777,"Wales",20,8,12,0,0,0,1,0,1,0,0,7,3,4,13,5,8,1,0,365,176,19
"1854","Ben Godfrey",23,"1998","01","15","2020/2021","Midfielder","Everton",2683,1243,1440,"England",31,15,16,0,0,0,2,0,2,0,0,11,3,8,35,18,17,4,0,289,180,-1
"1855","Ben Mee",32,"1989","09","21","2020/2021","Defender","Burnley",2694,1350,1344,"England",30,15,15,2,2,0,0,0,0,0,0,10,3,7,40,21,19,3,0,185,258,92
"1856","Ben Osborn",27,"1994","08","05","2020/2021","Midfielder","Sheffield United",1605,705,900,"England",24,11,13,1,0,1,0,0,0,0,0,5,4,1,27,8,19,1,0,214,408,-1
"1857","Ben White",24,"1997","10","08","2020/2021","Defender","Brighton & Hove Albion",3195,1582,1613,"England",36,18,18,0,0,0,0,0,0,0,0,12,7,5,40,18,22,5,1,406,388,55
"1858","Benjamin Johnson",21,"2000","01","24","2020/2021","Forward","West Ham United",519,253,266,"England",14,8,6,1,1,0,0,0,0,0,0,3,3,0,9,2,7,1,0,105,309,-1
"1859","Benjamin Mendy",27,"1994","07","17","2020/2021","Defender","Manchester City",955,508,447,"France",13,7,6,2,1,1,1,0,1,0,0,5,2,3,10,8,2,2,0,91,146,31
"1860","Benjamin Woodburn",22,"1999","10","15","2020/2021","Forward","Liverpool",0,0,0,"Wales",0,0,0,0,0,0,0,0,0,0,0,0,0,0,0,0,0,0,0,-1,-1,-1
"1861","Bernard Anício Caldeira Duarte",29,"1992","09","08","2020/2021","Midfielder","Everton",448,210,238,"Brazil",12,6,6,1,1,0,0,0,0,0,0,2,0,2,6,3,3,2,0,84,402,-1
"1862","Bernardo",26,"1995","05","14","2020/2021","Defender","Brighton & Hove Albion",204,90,114,"Brazil",3,1,2,0,0,0,0,0,0,0,0,0,0,0,3,1,2,0,0,-1,-1,-1
"1863","Bernardo Silva",27,"1994","08","10","2020/2021","Midfielder","Manchester City",2071,891,1180,"Portugal",26,11,15,2,1,1,6,1,5,0,0,13,7,6,16,4,12,5,0,160,21,-1
"1864","Bernd Leno",29,"1992","03","04","2020/2021","Goalkeeper","Arsenal",3132,1620,1512,"Germany",35,18,17,0,0,0,0,0,0,0,0,11,4,7,37,20,17,1,1,346,336,44
"1865","Bertrand Traoré",26,"1995","09","06","2020/2021","Forward","Aston Villa",2334,1163,1171,"Burkina Faso",36,18,18,7,5,2,6,3,3,0,0,13,6,7,31,20,11,1,0,60,37,-1
"1866","Billy Gilmour",20,"2001","06","11","2020/2021","Midfielder","Chelsea",260,162,98,"Scotland",5,3,2,0,0,0,0,0,0,0,0,1,1,0,2,1,1,0,0,-1,-1,-1
"1867","Billy Koumetio",19,"2002","11","14","2020/2021","Defender","Liverpool",0,0,0,"France",0,0,0,0,0,0,0,0,0,0,0,0,0,0,0,0,0,0,0,-1,-1,-1
"1868","Billy Sharp",35,"1986","02","05","2020/2021","Forward","Sheffield United",730,303,427,"England",16,9,7,3,3,0,0,0,0,2,0,1,1,0,14,4,10,1,0,38,404,-1
"1869","Bjorn Engels",27,"1994","09","15","2020/2021","Defender","Aston Villa",0,0,0,"Belgium",0,0,0,0,0,0,0,0,0,0,0,0,0,0,0,0,0,0,0,-1,-1,-1
"1870","Bobby Reid",28,"1993","02","02","2020/2021","Midfielder","Fulham",2381,919,1462,"England",33,15,18,5,3,2,2,0,2,0,0,9,5,4,30,12,18,7,0,88,164,-1
"1871","Bobby Thomas",0,"1970","01","01","2020/2021","Defender","Burnley",0,0,0,"England",0,0,0,0,0,0,0,0,0,0,0,0,0,0,0,0,0,0,0,-1,-1,-1
"1872","Brandon Williams",21,"2000","09","03","2020/2021","Defender","Manchester United",186,90,96,"England",4,1,3,0,0,0,0,0,0,0,0,1,0,1,3,2,1,0,0,-1,-1,-1
"1873","Branislav Ivanović",37,"1984","02","22","2020/2021","Defender","West Bromwich Albion",765,403,362,"Serbia",13,7,6,0,0,0,0,0,0,0,0,3,3,0,19,12,7,2,0,298,292,157
"1874","Bruno Miguel Borges Fernandes",27,"1994","09","08","2020/2021","Midfielder","Manchester United",3109,1551,1558,"Portugal",37,19,18,18,9,9,12,7,5,9,1,13,6,7,33,21,12,6,0,15,7,-1
"1875","Caglar Söyüncü",25,"1996","05","23","2020/2021","Defender","Leicester City",1815,891,924,"Turkey",23,11,12,1,0,1,0,0,0,0,0,6,3,3,29,19,10,2,0,225,327,109
"1876","Caleb Taylor",0,"1970","01","01","2020/2021","Midfielder","West Bromwich Albion",0,0,0,"England",0,0,0,0,0,0,0,0,0,0,0,0,0,0,0,0,0,0,0,-1,-1,-1
"1877","Caleb Watts",19,"2002","01","16","2020/2021","Midfielder","Southampton",36,16,20,"England",3,1,2,0,0,0,0,0,0,0,0,0,0,0,0,0,0,1,0,-1,-1,-1
"1878","Callum Hudson-Odoi",21,"2000","11","07","2020/2021","Midfielder","Chelsea",1055,619,436,"England",23,10,13,2,1,1,3,1,2,0,0,12,7,5,5,1,4,0,0,104,24,-1
"1879","Callum Robinson",26,"1995","02","02","2020/2021","Forward","West Bromwich Albion",1567,666,901,"England",28,13,15,5,3,2,0,0,0,0,0,3,3,0,42,20,22,0,0,56,324,-1
"1880","Callum Wilson",29,"1992","02","27","2020/2021","Forward","Newcastle United",2085,1049,1036,"England",26,13,13,12,5,7,5,3,2,4,0,4,1,3,35,19,16,2,0,14,42,-1
"1881","Calum Chambers",26,"1995","01","20","2020/2021","Defender","Arsenal",752,353,399,"England",10,4,6,0,0,0,2,2,0,0,0,4,1,3,10,5,5,0,0,273,30,74
"1882","Caoimhin Kelleher",22,"1998","11","23","2020/2021","Goalkeeper","Liverpool",180,180,0,"Republic of Ireland",2,2,0,0,0,0,0,0,0,0,0,1,1,0,1,1,0,0,0,-1,-1,-1
"1883","Carlos Vinícius Alves Morais",26,"1995","03","25","2020/2021","Midfielder","Tottenham Hotspur",304,112,192,"Brazil",9,4,5,1,0,1,0,0,0,0,0,3,1,2,2,1,1,2,0,51,243,-1
"1884","Carney Chukwuemeka",0,"1970","01","01","2020/2021","Midfielder","Aston Villa",18,17,1,"England",2,1,1,0,0,0,0,0,0,0,0,0,0,0,0,0,0,0,0,-1,-1,-1
"1885","Cedric Kipre",24,"1996","12","09","2020/2021","Defender","West Bromwich Albion",0,0,0,"France",0,0,0,0,0,0,0,0,0,0,0,0,0,0,0,0,0,0,0,-1,-1,-1
"1886","Cedric Soares",30,"1991","08","31","2020/2021","Defender","Arsenal",745,410,335,"Portugal",10,6,4,0,0,0,1,1,0,0,0,2,2,0,11,6,5,1,0,279,119,91
"1887","Cengiz Ünder",24,"1997","07","14","2020/2021","Midfielder","Leicester City",273,189,84,"Turkey",9,5,4,0,0,0,2,0,2,0,0,1,0,1,5,4,1,0,0,308,1,-1
"1888","Cenk Tosun",30,"1991","06","07","2020/2021","Forward","Everton",43,21,22,"Turkey",5,3,2,0,0,0,0,0,0,0,0,0,0,0,2,1,1,1,0,-1,-1,-1
"1889","Cesar Azpilicueta",32,"1989","08","28","2020/2021","Defender","Chelsea",2190,1156,1034,"Spain",26,13,13,1,1,0,2,0,2,0,0,13,7,6,18,12,6,6,1,230,155,11
"1890","Charlie Austin",32,"1989","07","05","2020/2021","Forward","West Bromwich Albion",132,56,76,"England",5,2,3,0,0,0,0,0,0,0,0,0,0,0,5,4,1,0,0,-1,-1,-1
"1891","Charlie Cresswell",18,"2002","12","07","2020/2021","Defender","Leeds United",0,0,0,"England",0,0,0,0,0,0,0,0,0,0,0,0,0,0,0,0,0,0,0,-1,-1,-1
"1892","Charlie Taylor",28,"1993","09","18","2020/2021","Defender","Burnley",2429,1152,1277,"England",29,14,15,0,0,0,1,1,0,0,0,10,3,7,41,19,22,1,0,378,220,117
"1893","Che Adams",25,"1996","07","13","2020/2021","Midfielder","Southampton",2675,1208,1467,"England",36,18,18,9,6,3,5,1,4,0,0,8,5,3,45,15,30,1,0,54,73,-1
"1894","Cheikh Sidya Diaby",21,"2000","03","07","2020/2021","Forward","West Bromwich Albion",0,0,0,"France",0,0,0,0,0,0,0,0,0,0,0,0,0,0,0,0,0,0,0,-1,-1,-1
"1895","Cheikhou Kouyaté",31,"1989","12","21","2020/2021","Midfielder","Crystal Palace",3122,1683,1439,"Senegal",36,19,17,1,1,0,0,0,0,0,0,8,6,2,51,25,26,4,0,251,331,-1
"1896","Chris Basham",33,"1988","07","20","2020/2021","Defender","Sheffield United",2586,1163,1423,"England",31,14,17,0,0,0,1,1,0,0,0,3,2,1,49,19,30,5,0,405,237,140
"1897","Chris Wood",29,"1991","12","07","2020/2021","Forward","Burnley",2750,1310,1440,"New Zealand",33,15,18,12,5,7,3,1,2,2,0,9,2,7,42,21,21,0,0,33,138,-1
"1898","Christian Benteke",30,"1990","12","03","2020/2021","Forward","Crystal Palace",1818,1013,805,"Belgium",30,16,14,10,3,7,1,1,0,0,0,6,4,2,32,18,14,3,1,18,206,-1
"1899","Christian Fuchs",35,"1986","04","07","2020/2021","Defender","Leicester City",702,360,342,"Austria",9,4,5,0,0,0,0,0,0,0,0,3,2,1,9,4,5,4,0,335,330,63
"1900","Christian Marques",18,"2003","01","15","2020/2021","Defender","Wolverhampton Wanderers",0,0,0,"Portugal",0,0,0,0,0,0,0,0,0,0,0,0,0,0,0,0,0,0,0,-1,-1,-1
"1901","Christian Pulisic",23,"1998","09","18","2020/2021","Midfielder","Chelsea",1735,833,902,"USA",27,15,12,4,2,2,2,1,1,0,0,14,8,6,20,10,10,2,0,81,133,-1
"1902","Christian Walton",26,"1995","11","09","2020/2021","Goalkeeper","Brighton & Hove Albion",0,0,0,"England",0,0,0,0,0,0,0,0,0,0,0,0,0,0,0,0,0,0,0,-1,-1,-1
"1903","Ciaran Clark",32,"1989","09","26","2020/2021","Defender","Newcastle United",1893,893,1000,"Republic of Ireland",22,10,12,1,0,1,0,0,0,0,0,4,1,3,35,14,21,3,0,219,380,137
"1904","Claudio Gomes",21,"2000","07","23","2020/2021","Midfielder","Manchester City",0,0,0,"France",0,0,0,0,0,0,0,0,0,0,0,0,0,0,0,0,0,0,0,-1,-1,-1
"1905","Cody Drameh",0,"1970","01","01","2020/2021","Midfielder","Leeds United",0,0,0,"England",0,0,0,0,0,0,0,0,0,0,0,0,0,0,0,0,0,0,0,-1,-1,-1
"1906","Cole Palmer",19,"2002","05","06","2020/2021","Defender","Manchester City",0,0,0,"England",0,0,0,0,0,0,0,0,0,0,0,0,0,0,0,0,0,0,0,-1,-1,-1
"1907","Connor Wickham",28,"1993","03","31","2020/2021","Forward","Crystal Palace",0,0,0,"England",0,0,0,0,0,0,0,0,0,0,0,0,0,0,0,0,0,0,0,-1,-1,-1
"1908","Conor Coady",28,"1993","02","25","2020/2021","Midfielder","Wolverhampton Wanderers",3304,1594,1710,"England",37,18,19,1,0,1,0,0,0,0,0,10,5,5,45,22,23,5,0,256,412,-1
"1909","Conor Coventry",21,"2000","03","25","2020/2021","Midfielder","West Ham United",0,0,0,"Republic of Ireland",0,0,0,0,0,0,0,0,0,0,0,0,0,0,0,0,0,0,0,-1,-1,-1
"1910","Conor Gallagher",21,"2000","02","06","2020/2021","Midfielder","West Bromwich Albion",2532,1356,1176,"England",30,16,14,2,2,0,2,2,0,0,0,6,5,1,45,27,18,11,0,195,166,-1
"1911","Conor Hourihane",30,"1991","02","02","2020/2021","Midfielder","Aston Villa",227,77,150,"Republic of Ireland",4,2,2,1,0,1,1,0,1,0,0,2,1,1,2,0,2,0,0,-1,-1,-1
"1912","Conor Townsend",28,"1993","10","08","2020/2021","Defender","West Bromwich Albion",2235,1065,1170,"England",25,12,13,0,0,0,2,1,1,0,0,6,5,1,32,10,22,0,0,268,158,88
"1913","Craig Dawson",31,"1990","05","06","2020/2021","Defender","West Ham United",1926,900,1026,"England",22,10,12,3,2,1,0,0,0,0,0,7,4,3,20,10,10,5,1,124,259,27
"1914","Crysencio Summerville",20,"2001","10","30","2020/2021","Forward","Leeds United",0,0,0,"Netherlands",0,0,0,0,0,0,0,0,0,0,0,0,0,0,0,0,0,0,0,-1,-1,-1
"1915","Curtis Jones",20,"2001","01","30","2020/2021","Midfielder","Liverpool",1177,678,499,"England",24,13,11,1,0,1,2,0,2,0,0,7,4,3,11,6,5,2,0,171,95,-1
"1916","Cyrus Christie",29,"1992","09","30","2020/2021","Defender","Fulham",0,0,0,"Republic of Ireland",0,0,0,0,0,0,0,0,0,0,0,0,0,0,0,0,0,0,0,-1,-1,-1
"1917","Dale Stephens",32,"1989","06","12","2020/2021","Midfielder","Burnley",259,166,93,"England",7,4,3,0,0,0,0,0,0,0,0,1,1,0,4,2,2,1,0,-1,-1,-1
"1918","Damián Emiliano Martínez",29,"1992","09","02","2020/2021","Goalkeeper","Aston Villa",3420,1710,1710,"Argentina",38,19,19,0,0,0,0,0,0,0,0,15,7,8,43,27,16,1,0,383,386,56
"1919","Dan Burn",29,"1992","05","09","2020/2021","Defender","Brighton & Hove Albion",2060,900,1160,"England",27,12,15,1,1,0,0,0,0,0,0,9,5,4,26,11,15,5,0,245,364,60
"1920","Dan Nlundulu",22,"1999","02","05","2020/2021","Forward","Southampton",98,47,51,"England",13,9,4,0,0,0,0,0,0,0,0,4,3,1,0,0,0,0,0,-1,-1,-1
"1921","Dane Scarlett",0,"1970","01","01","2020/2021","Forward","Tottenham Hotspur",0,0,0,"England",1,1,0,0,0,0,0,0,0,0,0,1,1,0,0,0,0,0,0,-1,-1,-1
"1922","Dani Ceballos",25,"1996","08","07","2020/2021","Midfielder","Arsenal",1614,968,646,"Spain",25,14,11,0,0,0,3,2,1,0,0,7,1,6,17,13,4,4,0,349,81,-1
"1923","Daniel Amartey",26,"1994","12","21","2020/2021","Midfielder","Leicester City",720,256,464,"Ghana",12,4,8,1,0,1,0,0,0,0,0,2,0,2,12,5,7,3,0,129,276,-1
"1924","Daniel Castelo Podence",26,"1995","10","21","2020/2021","Forward","Wolverhampton Wanderers",1679,979,700,"Portugal",24,13,11,3,2,1,2,1,1,0,0,7,3,4,21,13,8,3,0,113,125,-1
"1925","Daniel James",24,"1997","11","10","2020/2021","Midfielder","Manchester United",913,423,490,"Wales",15,8,7,3,3,0,1,0,1,0,0,7,3,4,7,4,3,3,0,52,136,-1
"1926","Daniel Jebbison",0,"1970","01","01","2020/2021","Midfielder","Sheffield United",284,104,180,"England",4,2,2,1,0,1,0,0,0,0,0,2,1,1,2,1,1,0,0,47,418,-1
"1927","Daniel Langley",0,"1970","01","01","2020/2021","Defender","Newcastle United",0,0,0,"England",0,0,0,0,0,0,0,0,0,0,0,0,0,0,0,0,0,0,0,-1,-1,-1
"1928","Daniel William John Ings",29,"1992","07","23","2020/2021","Forward","Southampton",2183,1171,1012,"England",29,15,14,12,7,5,4,4,0,2,0,7,5,2,39,17,22,1,0,22,87,-1
"1929","Danny Ward",28,"1993","06","22","2020/2021","Goalkeeper","Leicester City",0,0,0,"Wales",0,0,0,0,0,0,0,0,0,0,0,0,0,0,0,0,0,0,0,-1,-1,-1
"1930","Danny Welbeck",30,"1990","11","26","2020/2021","Forward","Brighton & Hove Albion",1547,728,819,"England",24,12,12,6,4,2,1,0,1,0,1,7,5,2,16,5,11,0,0,42,188,-1
"1931","Dara O'Shea",22,"1999","03","04","2020/2021","Defender","West Bromwich Albion",2102,1056,1046,"Republic of Ireland",28,14,14,0,0,0,0,0,0,0,0,4,3,1,49,26,23,3,0,330,320,153
"1932","Darnell Furlong",26,"1995","10","31","2020/2021","Defender","West Bromwich Albion",2931,1643,1288,"England",35,19,16,1,0,1,3,2,1,0,0,6,5,1,59,34,25,5,0,252,147,146
"1933","Darren Randolph",34,"1987","05","12","2020/2021","Goalkeeper","West Ham United",270,0,270,"Republic of Ireland",3,0,3,0,0,0,0,0,0,0,0,1,0,1,3,0,3,0,0,-1,-1,-1
"1934","David Button",32,"1989","02","27","2020/2021","Goalkeeper","West Bromwich Albion",90,0,90,"England",1,0,1,0,0,0,0,0,0,0,0,0,0,0,2,0,2,0,0,-1,-1,-1
"1935","David de Gea",31,"1990","11","07","2020/2021","Goalkeeper","Manchester United",2296,1350,946,"Spain",26,15,11,0,0,0,0,0,0,0,0,9,5,4,30,21,9,0,0,370,361,71
"1936","David Luiz",34,"1987","04","22","2020/2021","Defender","Arsenal",1397,669,728,"Brazil",20,11,9,1,0,1,0,0,0,0,0,4,3,1,18,6,12,2,1,198,379,68
"1937","David Martin",35,"1986","01","22","2020/2021","Goalkeeper","West Ham United",0,0,0,"England",0,0,0,0,0,0,0,0,0,0,0,0,0,0,0,0,0,0,0,-1,-1,-1
"1938","David McGoldrick",33,"1987","11","29","2020/2021","Forward","Sheffield United",2402,1228,1174,"Republic of Ireland",35,18,17,8,6,2,1,0,1,0,0,5,4,1,36,14,22,7,0,53,221,-1
"1939","Davinson Sánchez Mina",25,"1996","06","12","2020/2021","Defender","Tottenham Hotspur",1486,540,946,"Colombia",18,6,12,0,0,0,0,0,0,0,0,4,2,2,19,4,15,1,0,398,397,62
"1940","Davy Pröpper",30,"1991","09","02","2020/2021","Midfielder","Brighton & Hove Albion",210,120,90,"Netherlands",7,4,3,0,0,0,0,0,0,0,0,3,2,1,2,1,1,0,0,-1,-1,-1
"1941","Dean Henderson",24,"1997","03","12","2020/2021","Goalkeeper","Manchester United",1124,360,764,"England",13,4,9,0,0,0,0,0,0,0,0,4,1,3,11,5,6,3,0,371,376,21
"1942","DeAndre Yedlin",28,"1993","07","09","2020/2021","Defender","Newcastle United",437,263,174,"USA",6,4,2,0,0,0,0,0,0,0,0,1,1,0,6,3,3,0,0,306,271,80
"1943","Declan Rice",22,"1999","01","14","2020/2021","Midfielder","West Ham United",2880,1440,1440,"Republic of Ireland",32,16,16,2,2,0,1,1,0,1,1,11,6,5,36,18,18,2,0,197,232,-1
"1944","Dele Alli",25,"1996","04","11","2020/2021","Midfielder","Tottenham Hotspur",618,320,298,"England",15,5,10,0,0,0,1,0,1,0,0,4,3,1,8,2,6,0,0,393,93,-1
"1945","Demarai Gray",25,"1996","06","28","2020/2021","Midfielder","Leicester City",18,0,18,"England",1,0,1,0,0,0,0,0,0,0,0,0,0,0,0,0,0,0,0,-1,-1,-1
"1946","Denis Odoi",33,"1988","05","27","2020/2021","Defender","Fulham",270,180,90,"Belgium",3,2,1,0,0,0,0,0,0,0,0,0,0,0,10,6,4,1,0,-1,-1,-1
"1947","Dennis Praet",27,"1994","05","14","2020/2021","Midfielder","Leicester City",723,298,425,"Belgium",15,6,9,1,1,0,1,0,1,0,0,6,3,3,11,4,7,0,0,138,118,-1
"1948","Diego Llorente",28,"1993","08","16","2020/2021","Defender","Leeds United",1206,630,576,"Spain",15,7,8,1,1,0,0,0,0,0,0,5,3,2,11,4,7,1,0,196,281,14
"1949","Diogo José Teixeira da Silva",24,"1996","12","04","2020/2021","Midfielder","Liverpool",1112,564,548,"Portugal",19,11,8,9,4,5,0,0,0,0,0,6,4,2,14,3,11,2,0,3,417,-1
"1950","Divock Origi",26,"1995","04","18","2020/2021","Forward","Liverpool",181,92,89,"Belgium",9,6,3,0,0,0,0,0,0,0,0,2,2,0,0,0,0,0,0,-1,-1,-1
"1951","Dominic Calvert-Lewin",24,"1997","03","16","2020/2021","Forward","Everton",2876,1409,1467,"England",33,16,17,16,7,9,0,0,0,0,0,11,3,8,36,17,19,3,0,17,401,-1
"1952","Donny van de Beek",24,"1997","04","18","2020/2021","Midfielder","Manchester United",512,250,262,"Netherlands",19,11,8,1,1,0,1,1,0,0,0,3,2,1,11,6,5,1,0,94,66,-1
"1953","Douglas Luiz",23,"1998","05","09","2020/2021","Midfielder","Aston Villa",2790,1343,1447,"Brazil",33,16,17,0,0,0,2,1,1,0,0,12,5,7,38,24,14,10,1,386,184,-1
"1954","Dwight Gayle",31,"1990","10","17","2020/2021","Forward","Newcastle United",504,275,229,"England",18,9,9,1,1,0,1,0,1,0,0,3,1,2,9,3,6,0,0,96,69,-1
"1955","Dwight McNeil",21,"1999","11","22","2020/2021","Forward","Burnley",3070,1516,1554,"England",36,18,18,2,1,1,5,1,4,0,0,10,2,8,49,24,25,1,0,204,91,-1
"1956","Eberechi Eze",23,"1998","06","29","2020/2021","Midfielder","Crystal Palace",2564,1218,1346,"Nigeria",34,16,18,4,3,1,6,2,4,0,0,8,6,2,49,23,26,3,0,119,44,-1
"1957","Ederson",28,"1993","08","17","2020/2021","Goalkeeper","Manchester City",3240,1710,1530,"Brazil",36,19,17,0,0,0,1,1,0,0,0,19,10,9,26,15,11,3,0,366,226,10
"1958","Edinson Cavani",34,"1987","02","14","2020/2021","Forward","Manchester United",1368,671,697,"Uruguay",26,13,13,10,4,6,3,1,2,0,0,9,4,5,15,10,5,4,0,5,57,-1
"1959","Edouard Mendy",29,"1992","03","01","2020/2021","Goalkeeper","Chelsea",2746,1260,1486,"France",31,14,17,0,0,0,0,0,0,0,0,16,8,8,23,11,12,2,0,284,280,12
"1960","Edward Nketiah",22,"1999","05","30","2020/2021","Forward","Arsenal",413,281,132,"England",17,10,7,2,2,0,1,1,0,0,0,5,2,3,6,3,3,0,0,28,41,-1
"1961","Elia Caprile",20,"2001","08","25","2020/2021","Goalkeeper","Leeds United",0,0,0,"Italy",0,0,0,0,0,0,0,0,0,0,0,0,0,0,0,0,0,0,0,-1,-1,-1
"1962","Elliott Anderson",0,"1970","01","01","2020/2021","Midfielder","Newcastle United",3,0,3,"England",1,0,1,0,0,0,0,0,0,0,0,0,0,0,0,0,0,0,0,-1,-1,-1
"1963","Ellis Simms",20,"2001","01","05","2020/2021","Midfielder","Everton",0,0,0,"England",0,0,0,0,0,0,0,0,0,0,0,0,0,0,0,0,0,0,0,-1,-1,-1
"1964","Emerson Palmieri dos Santos",27,"1994","08","03","2020/2021","Defender","Chelsea",89,81,8,"Italy",2,1,1,0,0,0,0,0,0,0,0,2,1,1,0,0,0,0,0,-1,-1,-1
"1965","Emil Krafth",27,"1994","08","02","2020/2021","Defender","Newcastle United",1291,740,551,"Sweden",16,9,7,1,1,0,0,0,0,0,0,3,1,2,25,12,13,4,0,183,317,143
"1966","Emile Smith Rowe",21,"2000","07","28","2020/2021","Midfielder","Arsenal",1448,792,656,"England",20,11,9,2,1,1,4,3,1,0,0,7,4,3,10,4,6,0,0,137,27,-1
"1967","Enda Stevens",31,"1990","07","09","2020/2021","Defender","Sheffield United",2700,1260,1440,"Republic of Ireland",30,14,16,0,0,0,1,1,0,0,0,4,3,1,53,21,32,6,0,407,228,145
"1968","Eric Bertrand Bailly",27,"1994","04","12","2020/2021","Defender","Manchester United",916,446,470,"Côte d'Ivoire",12,5,7,0,0,0,0,0,0,0,0,3,1,2,16,12,4,3,0,372,377,120
"1969","Eric Dier",27,"1994","01","15","2020/2021","Midfielder","Tottenham Hotspur",2520,1350,1170,"England",28,15,13,0,0,0,0,0,0,0,0,8,5,3,30,14,16,3,0,395,393,-1
"1970","Eric García Martret",20,"2001","01","09","2020/2021","Defender","Manchester City",380,110,270,"Spain",6,2,4,0,0,0,0,0,0,0,0,2,1,1,12,5,7,0,0,305,272,162
"1971","Erik Lamela",29,"1992","03","04","2020/2021","Midfielder","Tottenham Hotspur",719,310,409,"Argentina",23,11,12,1,0,1,0,0,0,0,0,5,3,2,14,4,10,6,1,131,396,-1
"1972","Erik Pieters",33,"1988","08","07","2020/2021","Defender","Burnley",1261,594,667,"Netherlands",20,9,11,0,0,0,1,1,0,0,0,6,2,4,19,9,10,1,0,381,173,99
"1973","Ethan Ampadu",21,"2000","09","14","2020/2021","Midfielder","Sheffield United",2090,1027,1063,"Wales",25,12,13,0,0,0,0,0,0,0,0,2,2,0,40,18,22,3,0,413,407,-1
"1974","Ezdzhan Alioski",29,"1992","02","12","2020/2021","Forward","Leeds United",2464,1223,1241,"FYR Macedonia",36,18,18,2,1,1,3,1,2,0,0,12,6,6,33,10,23,7,0,186,128,-1
"1975","Ezri Konsa Ngoyo",23,"1998","04","06","2020/2021","Midfielder","Aston Villa",3195,1575,1620,"England",36,18,18,2,2,0,0,0,0,0,0,13,6,7,43,27,16,3,0,206,387,-1
"1976","Fabián Cornelio Balbuena González",30,"1991","08","23","2020/2021","Defender","West Ham United",1198,658,540,"Paraguay",14,8,6,1,0,1,0,0,0,0,0,4,2,2,18,9,9,2,1,167,310,95
"1977","Fabian Delph",31,"1989","11","21","2020/2021","Midfielder","Everton",261,81,180,"England",8,3,5,0,0,0,0,0,0,0,0,2,0,2,5,2,3,1,0,-1,-1,-1
"1978","Fabian Schär",29,"1991","12","20","2020/2021","Defender","Newcastle United",1255,698,557,"Switzerland",18,10,8,1,0,1,0,0,0,1,0,4,1,3,18,10,8,5,1,182,283,87
"1979","Fabinho",28,"1993","10","23","2020/2021","Midfielder","Liverpool",2565,1305,1260,"Brazil",30,16,14,0,0,0,0,0,0,0,0,11,5,6,27,12,15,6,0,361,355,-1
"1980","Fabio Carvalho",19,"2002","08","30","2020/2021","Midfielder","Fulham",255,90,165,"England",4,1,3,1,0,1,0,0,0,0,0,0,0,0,6,2,4,0,0,-1,-1,-1
"1981","Fábio Daniel Soares Silva",19,"2002","07","19","2020/2021","Forward","Wolverhampton Wanderers",1352,742,610,"Portugal",32,16,16,4,2,2,3,2,1,1,0,6,4,2,23,11,12,2,0,61,51,-1
"1982","Fabricio Martín Agosto Ramírez",33,"1987","12","31","2020/2021","Goalkeeper","Fulham",0,0,0,"Spain",0,0,0,0,0,0,0,0,0,0,0,0,0,0,0,0,0,0,0,-1,-1,-1
"1983","Faustino Anjorin",19,"2001","11","23","2020/2021","Defender","Chelsea",0,0,0,"England",0,0,0,0,0,0,0,0,0,0,0,0,0,0,0,0,0,0,0,-1,-1,-1
"1984","Federico Fernández",32,"1989","02","21","2020/2021","Defender","Newcastle United",2083,1016,1067,"Argentina",24,12,12,0,0,0,0,0,0,0,0,5,2,3,35,19,16,4,0,321,312,115
"1985","Felipe Anderson Pereira Gomes",28,"1993","04","15","2020/2021","Midfielder","West Ham United",1,1,0,"Brazil",2,1,1,0,0,0,0,0,0,0,0,0,0,0,0,0,0,0,0,-1,-1,-1
"1986","Felix Kalu Nmecha",21,"2000","10","10","2020/2021","Midfielder","Manchester City",0,0,0,"England",0,0,0,0,0,0,0,0,0,0,0,0,0,0,0,0,0,0,0,-1,-1,-1
"1987","Femi Seriki",0,"1970","01","01","2020/2021","Midfielder","Sheffield United",0,0,0,"England",1,0,1,0,0,0,0,0,0,0,0,0,0,0,0,0,0,0,0,-1,-1,-1
"1988","Fernando Luiz Rosa",36,"1985","05","04","2020/2021","Midfielder","Manchester City",1181,669,512,"Brazil",21,10,11,0,0,0,2,2,0,0,0,11,6,5,8,5,3,6,0,313,94,-1
"1989","Fernando Marçal",32,"1989","02","19","2020/2021","Defender","Wolverhampton Wanderers",620,314,306,"Brazil",13,7,6,0,0,0,0,0,0,0,0,3,1,2,8,3,5,2,0,416,411,66
"1990","Ferrán Torres García",21,"2000","02","29","2020/2021","Forward","Manchester City",1306,632,674,"Spain",24,12,12,7,3,4,2,1,1,0,0,13,6,7,12,6,6,1,0,24,103,-1
"1991","Fikayo Tomori",23,"1997","12","19","2020/2021","Defender","Chelsea",44,44,0,"England",1,1,0,0,0,0,0,0,0,0,0,0,0,0,2,2,0,0,0,-1,-1,-1
"1992","Filip Krovinović",26,"1995","08","29","2020/2021","Midfielder","West Bromwich Albion",543,246,297,"Croatia",11,5,6,0,0,0,0,0,0,0,0,2,2,0,11,5,6,0,0,300,291,-1
"1993","Florin Andone",28,"1993","04","11","2020/2021","Forward","Brighton & Hove Albion",0,0,0,"Romania",0,0,0,0,0,0,0,0,0,0,0,0,0,0,0,0,0,0,0,-1,-1,-1
"1994","Frankie Maguire",0,"1970","01","01","2020/2021","Midfielder","Sheffield United",0,0,0,"England",0,0,0,0,0,0,0,0,0,0,0,0,0,0,0,0,0,0,0,-1,-1,-1
"1995","Fraser Forster",33,"1988","03","17","2020/2021","Goalkeeper","Southampton",720,360,360,"England",8,4,4,0,0,0,0,0,0,0,0,2,1,1,10,5,5,0,0,358,349,81
"1996","Frédéric Guilbert",26,"1994","12","24","2020/2021","Defender","Aston Villa",0,0,0,"France",0,0,0,0,0,0,0,0,0,0,0,0,0,0,0,0,0,0,0,-1,-1,-1
"1997","Frederico Rodrigues Santos",28,"1993","03","05","2020/2021","Midfielder","Manchester United",2396,1160,1236,"Brazil",30,15,15,1,0,1,0,0,0,0,0,11,5,6,23,13,10,5,0,229,374,-1
"1998","Frederik Alves Ibsen",19,"2002","01","01","2020/2021","Defender","West Ham United",0,0,0,"Denmark",0,0,0,0,0,0,0,0,0,0,0,0,0,0,0,0,0,0,0,-1,-1,-1
"1999","Gabriel dos Santos Magalhães",23,"1997","12","19","2020/2021","Defender","Arsenal",1996,1142,854,"Brazil",23,13,10,2,1,1,0,0,0,0,0,6,1,5,24,18,6,4,1,157,337,47
"2000","Gabriel Jesus",24,"1997","04","03","2020/2021","Forward","Manchester City",2060,1117,943,"Brazil",29,15,14,9,5,4,4,1,3,0,0,15,8,7,15,7,8,2,0,34,76,-1
"2001","Gabriel Teodoro Martinelli Silva",20,"2001","06","18","2020/2021","Midfielder","Arsenal",588,309,279,"Brazil",14,8,6,2,0,2,1,0,1,0,0,6,3,3,3,3,0,0,0,48,97,-1
"2002","Gaetano Berardi",33,"1988","08","21","2020/2021","Defender","Leeds United",113,69,44,"Switzerland",2,1,1,0,0,0,0,0,0,0,0,1,0,1,0,0,0,0,0,-1,-1,-1
"2003","Gareth Bale",32,"1989","07","16","2020/2021","Forward","Tottenham Hotspur",921,504,417,"Wales",20,11,9,11,9,2,2,1,1,0,0,5,3,2,10,5,5,1,0,1,54,-1
"2004","Gary Cahill",35,"1985","12","19","2020/2021","Defender","Crystal Palace",1800,990,810,"England",20,11,9,1,0,1,1,0,1,0,0,4,3,1,35,19,16,3,0,224,204,144
"2005","Gedson Carvalho Fernandes",22,"1999","01","09","2020/2021","Midfielder","Tottenham Hotspur",0,0,0,"Portugal",0,0,0,0,0,0,0,0,0,0,0,0,0,0,0,0,0,0,0,-1,-1,-1
"2006","George Baldock",28,"1993","03","09","2020/2021","Defender","Sheffield United",2789,1394,1395,"England",32,16,16,0,0,0,2,1,1,0,0,4,3,1,50,21,29,7,0,408,193,130
"2007","Georginio Wijnaldum",30,"1990","11","11","2020/2021","Midfielder","Liverpool",2946,1623,1323,"Netherlands",38,19,19,2,1,1,0,0,0,0,0,12,5,7,37,19,18,1,0,208,353,-1
"2008","Giovani Lo Celso",25,"1996","04","09","2020/2021","Midfielder","Tottenham Hotspur",949,528,421,"Argentina",18,9,9,1,1,0,1,0,1,0,0,8,4,4,9,3,6,5,0,161,151,-1
"2009","Grady Diangana",23,"1998","04","19","2020/2021","Midfielder","West Bromwich Albion",1239,631,608,"England",20,11,9,1,0,1,0,0,0,0,0,2,2,0,31,17,14,0,0,192,323,-1
"2010","Granit Xhaka",29,"1992","09","27","2020/2021","Midfielder","Arsenal",2522,1225,1297,"Switzerland",31,15,16,1,1,0,2,1,1,0,0,10,4,6,26,12,14,8,1,234,167,-1
"2011","Gylfi Sigurdsson",32,"1989","09","08","2020/2021","Midfielder","Everton",2255,1164,1091,"Iceland",36,17,19,6,3,3,5,4,1,3,1,12,3,9,27,15,12,2,0,71,55,-1
"2012","Hakim Ziyech",28,"1993","03","19","2020/2021","Midfielder","Chelsea",1179,634,545,"Morocco",23,11,12,2,0,2,3,2,1,0,0,12,5,7,6,5,1,3,0,114,35,-1
"2013","Hal Robson-Kanu",32,"1989","05","21","2020/2021","Forward","West Bromwich Albion",546,315,231,"Wales",19,10,9,2,1,1,0,0,0,0,0,4,4,0,10,7,3,2,0,46,325,-1
"2014","Hamza Choudhury",24,"1997","10","01","2020/2021","Midfielder","Leicester City",313,16,297,"England",10,3,7,0,0,0,0,0,0,0,0,2,0,2,1,0,1,1,0,336,359,-1
"2015","Hannibal Mejbri",18,"2003","01","21","2020/2021","Midfielder","Manchester United",8,0,8,"France",1,0,1,0,0,0,0,0,0,0,0,0,0,0,0,0,0,0,0,-1,-1,-1
"2016","Harrison Reed",26,"1995","01","27","2020/2021","Midfielder","Fulham",2250,1165,1085,"England",31,16,15,0,0,0,2,1,1,0,0,9,5,4,33,17,16,5,0,342,163,-1
"2017","Harry Boyes",0,"1970","01","01","2020/2021","Defender","Sheffield United",0,0,0,"England",0,0,0,0,0,0,0,0,0,0,0,0,0,0,0,0,0,0,0,-1,-1,-1
"2018","Harry Kane",28,"1993","07","28","2020/2021","Forward","Tottenham Hotspur",3087,1473,1614,"England",35,17,18,23,11,12,14,7,7,4,0,12,7,5,35,13,22,1,0,4,5,-1
"2019","Harry Lewis",23,"1997","12","20","2020/2021","Goalkeeper","Southampton",0,0,0,"England",0,0,0,0,0,0,0,0,0,0,0,0,0,0,0,0,0,0,0,-1,-1,-1
"2020","Harry Maguire",28,"1993","03","05","2020/2021","Defender","Manchester United",3048,1440,1608,"England",34,16,18,2,1,1,1,1,0,0,0,13,6,7,34,20,14,11,0,199,224,37
"2021","Harry Tyrer",0,"1970","01","01","2020/2021","Goalkeeper","Everton",0,0,0,"England",0,0,0,0,0,0,0,0,0,0,0,0,0,0,0,0,0,0,0,-1,-1,-1
"2022","Harry Winks",25,"1996","02","02","2020/2021","Midfielder","Tottenham Hotspur",860,590,270,"England",15,12,3,0,0,0,0,0,0,0,0,3,3,0,13,9,4,5,0,396,394,-1
"2023","Harvey Lewis Barnes",23,"1997","12","09","2020/2021","Midfielder","Leicester City",1949,951,998,"England",25,13,12,9,6,3,4,2,2,0,0,9,4,5,24,15,9,0,0,30,65,-1
"2024","Hector Bellerin",26,"1995","03","19","2020/2021","Defender","Arsenal",2093,1042,1051,"Spain",25,12,13,1,1,0,2,2,0,0,0,9,2,7,24,14,10,8,0,244,143,40
"2025","Hélder Wander Sousa Azevedo Costa",27,"1994","01","12","2020/2021","Midfielder","Leeds United",1155,661,494,"Portugal",22,11,11,3,2,1,3,1,2,0,0,7,3,4,22,11,11,0,0,75,33,-1
"2026","Heung-Min Son",29,"1992","07","08","2020/2021","Forward","Tottenham Hotspur",3126,1649,1477,"South Korea",37,19,18,17,8,9,10,7,3,1,0,11,7,4,34,15,19,0,0,21,12,-1
"2027","Hugo Bueno",0,"1970","01","01","2020/2021","Defender","Wolverhampton Wanderers",0,0,0,"Portugal",0,0,0,0,0,0,0,0,0,0,0,0,0,0,0,0,0,0,0,-1,-1,-1
"2028","Hugo Lloris",34,"1986","12","26","2020/2021","Goalkeeper","Tottenham Hotspur",3420,1710,1710,"France",38,19,19,0,0,0,0,0,0,0,0,12,7,5,40,17,23,0,0,364,390,41
"2029","Ian Poveda",21,"2000","02","09","2020/2021","Midfielder","Leeds United",341,197,144,"England",14,8,6,0,0,0,0,0,0,0,0,6,3,3,3,1,2,0,0,315,303,-1
"2030","Ibrahima Diallo",22,"1999","03","08","2020/2021","Midfielder","Southampton",1010,465,545,"France",22,11,11,0,0,0,0,0,0,0,0,5,3,2,16,8,8,3,0,286,298,-1
"2031","Iliman Ndiaye",0,"1970","01","01","2020/2021","Midfielder","Sheffield United",11,0,11,"France",1,0,1,0,0,0,0,0,0,0,0,0,0,0,1,0,1,0,0,-1,-1,-1
"2032","İlkay Gündoğan",31,"1990","10","24","2020/2021","Midfielder","Manchester City",2031,1213,818,"Germany",28,17,11,13,7,6,2,0,2,1,1,14,9,5,14,7,7,1,0,10,152,-1
"2033","Illan Meslier",21,"2000","03","02","2020/2021","Goalkeeper","Leeds United",3150,1530,1620,"France",35,17,18,0,0,0,0,0,0,0,0,11,6,5,50,18,32,0,0,363,357,107
"2034","Isaac Hayden",26,"1995","03","22","2020/2021","Midfielder","Newcastle United",1943,998,945,"England",24,13,11,0,0,0,0,0,0,0,0,4,1,3,32,16,16,8,0,324,314,-1
"2035","Isaac Price",18,"2003","09","26","2020/2021","Midfielder","Everton",0,0,0,"Northern Ireland",0,0,0,0,0,0,0,0,0,0,0,0,0,0,0,0,0,0,0,-1,-1,-1
"2036","Islam Slimani",33,"1988","06","18","2020/2021","Forward","Leicester City",19,19,0,"Algeria",1,1,0,0,0,0,0,0,0,0,0,0,0,0,0,0,0,0,0,-1,-1,-1
"2037","Issa Diop",24,"1997","01","09","2020/2021","Defender","West Ham United",1378,837,541,"France",18,11,7,2,1,1,0,0,0,0,0,4,4,0,21,10,11,3,0,128,306,102
"2038","Ivan Ricardo Neves Abreu Cavaleiro",28,"1993","10","18","2020/2021","Forward","Fulham",2474,1334,1140,"Portugal",36,18,18,3,0,3,0,0,0,1,1,9,5,4,41,23,18,2,0,145,333,-1
"2039","Jack Butland",28,"1993","03","10","2020/2021","Goalkeeper","Crystal Palace",90,90,0,"England",1,1,0,0,0,0,0,0,0,0,0,0,0,0,2,2,0,0,0,-1,-1,-1
"2040","Jack Cork",32,"1989","06","25","2020/2021","Midfielder","Burnley",1352,731,621,"England",16,9,7,0,0,0,0,0,0,0,0,4,1,3,23,14,9,2,0,287,294,-1
"2041","Jack Grealish",26,"1995","09","10","2020/2021","Midfielder","Aston Villa",2184,1005,1179,"England",26,12,14,6,3,3,10,6,4,0,0,13,6,7,27,15,12,6,0,67,4,-1
"2042","Jack Harrison",24,"1996","11","20","2020/2021","Midfielder","Leeds United",2857,1399,1458,"England",36,18,18,8,3,5,8,3,5,0,0,12,6,6,43,16,27,2,0,65,29,-1
"2043","Jack Jenkins",0,"1970","01","01","2020/2021","Midfielder","Leeds United",0,0,0,"England",0,0,0,0,0,0,0,0,0,0,0,0,0,0,0,0,0,0,0,-1,-1,-1
"2044","Jack O'Connell",27,"1994","03","29","2020/2021","Defender","Sheffield United",180,90,90,"England",2,1,1,0,0,0,0,0,0,0,0,0,0,0,3,2,1,0,0,-1,-1,-1
"2045","Jack Robinson",28,"1993","09","01","2020/2021","Defender","Sheffield United",875,459,416,"England",11,6,5,0,0,0,1,0,1,0,0,2,1,1,11,6,5,3,0,389,132,57
"2046","Jack Stephens",27,"1994","01","27","2020/2021","Defender","Southampton",1538,900,638,"England",18,10,8,0,0,0,0,0,0,0,0,4,3,1,32,13,19,2,0,356,346,150
"2047","Jacob Murphy",26,"1995","02","24","2020/2021","Midfielder","Newcastle United",1621,828,793,"England",26,13,13,2,0,2,3,3,0,0,0,3,2,1,32,17,15,3,0,148,71,-1
"2048","Jacob Ramsey",20,"2001","05","28","2020/2021","Midfielder","Aston Villa",618,171,447,"England",22,11,11,0,0,0,0,0,0,0,0,8,5,3,8,3,5,0,0,293,279,-1
"2049","Jaden Philogene-Bidace",0,"1970","01","01","2020/2021","Midfielder","Aston Villa",0,0,0,"England",1,0,1,0,0,0,0,0,0,0,0,0,0,0,0,0,0,0,0,-1,-1,-1
"2050","Jaïro Riedewald",25,"1996","09","09","2020/2021","Defender","Crystal Palace",1816,784,1032,"Netherlands",33,17,16,2,0,2,0,0,0,0,0,6,5,1,35,12,23,4,0,151,275,142
"2051","Jake Cain",20,"2001","09","02","2020/2021","Midfielder","Liverpool",0,0,0,"England",0,0,0,0,0,0,0,0,0,0,0,0,0,0,0,0,0,0,0,-1,-1,-1
"2052","Jake Livermore",31,"1989","11","14","2020/2021","Midfielder","West Bromwich Albion",1248,608,640,"England",18,9,9,0,0,0,0,0,0,0,0,1,1,0,31,14,17,3,1,331,321,-1
"2053","Jake Vokins",21,"2000","03","17","2020/2021","Defender","Southampton",66,66,0,"England",1,1,0,0,0,0,0,0,0,0,0,0,0,0,2,2,0,0,0,-1,-1,-1
"2054","Jakub Moder",22,"1999","04","07","2020/2021","Midfielder","Brighton & Hove Albion",647,356,291,"Poland",12,5,7,0,0,0,0,0,0,0,0,4,3,1,9,3,6,0,0,301,250,-1
"2055","Jakub Ojrzyński",18,"2003","02","19","2020/2021","Goalkeeper","Liverpool",0,0,0,"Poland",0,0,0,0,0,0,0,0,0,0,0,0,0,0,0,0,0,0,0,-1,-1,-1
"2056","Jamal Baptiste",18,"2003","11","11","2020/2021","Defender","West Ham United",0,0,0,"England",0,0,0,0,0,0,0,0,0,0,0,0,0,0,0,0,0,0,0,-1,-1,-1
"2057","Jamal Lascelles",27,"1993","11","11","2020/2021","Defender","Newcastle United",1628,676,952,"England",19,8,11,2,2,0,0,0,0,0,0,3,0,3,29,12,17,4,0,143,313,128
"2058","Jamal Lewis",23,"1998","01","25","2020/2021","Midfielder","Newcastle United",1834,889,945,"Northern Ireland",24,12,12,0,0,0,1,0,1,0,0,4,1,3,34,16,18,4,0,323,211,-1
"2059","James Justin",22,"1999","07","11","2020/2021","Midfielder","Leicester City",2070,990,1080,"England",23,11,12,2,1,1,1,1,0,0,0,9,4,5,24,14,10,4,0,164,217,-1
"2060","James Maddison",24,"1996","11","23","2020/2021","Midfielder","Leicester City",2104,1098,1006,"England",31,16,15,8,5,3,5,2,3,0,0,10,5,5,27,18,9,4,0,44,45,-1
"2061","James McArthur",34,"1987","10","07","2020/2021","Midfielder","Crystal Palace",1471,801,670,"Scotland",18,10,8,0,0,0,2,1,1,0,0,3,2,1,25,13,12,3,0,351,117,-1
"2062","James McCarthy",30,"1990","11","12","2020/2021","Midfielder","Crystal Palace",823,482,341,"Republic of Ireland",16,9,7,0,0,0,0,0,0,0,0,5,4,1,15,6,9,1,0,353,343,-1
"2063","James Milner",35,"1986","01","04","2020/2021","Midfielder","Liverpool",1061,441,620,"England",26,12,14,0,0,0,1,1,0,0,0,9,3,6,9,6,3,3,0,362,154,-1
"2064","James Rodriguez",30,"1991","07","12","2020/2021","Midfielder","Everton",1776,953,823,"Colombia",23,13,10,6,5,1,4,3,1,0,0,4,0,4,26,17,9,4,0,50,56,-1
"2065","James Tarkowski",28,"1992","11","19","2020/2021","Defender","Burnley",3240,1620,1620,"England",36,18,18,1,0,1,0,0,0,0,0,11,3,8,49,26,23,6,0,261,286,101
"2066","James Tomkins",32,"1989","03","29","2020/2021","Defender","Crystal Palace",552,314,238,"England",8,5,3,0,0,0,0,0,0,0,0,2,1,1,10,5,5,1,0,292,263,134
"2067","James Trafford",0,"1970","01","01","2020/2021","Goalkeeper","Manchester City",0,0,0,"England",0,0,0,0,0,0,0,0,0,0,0,0,0,0,0,0,0,0,0,-1,-1,-1
"2068","James Ward-Prowse",27,"1994","11","01","2020/2021","Midfielder","Southampton",3420,1710,1710,"England",38,19,19,8,3,5,7,4,3,3,1,9,6,3,59,23,36,5,0,82,70,-1
"2069","Jamie Shackelton",22,"1999","10","08","2020/2021","Midfielder","Leeds United",453,117,336,"England",13,5,8,0,0,0,0,0,0,0,0,4,2,2,11,3,8,0,0,337,328,-1
"2070","Jamie Vardy",34,"1987","01","11","2020/2021","Forward","Leicester City",2845,1523,1322,"England",34,17,17,15,6,9,9,7,2,8,1,10,6,4,43,25,18,1,0,26,17,-1
"2071","Jan Bednarek",25,"1996","04","12","2020/2021","Defender","Southampton",3104,1486,1618,"Poland",36,17,19,1,1,0,1,1,0,0,0,9,6,3,55,21,34,6,1,253,241,126
"2072","Jannik Vestergaard",29,"1992","08","03","2020/2021","Defender","Southampton",2574,1180,1394,"Denmark",30,14,16,3,0,3,0,0,0,0,0,6,4,2,40,13,27,4,1,154,347,103
"2073","Japhet Tanganga",22,"1999","03","31","2020/2021","Defender","Tottenham Hotspur",489,173,316,"England",6,2,4,0,0,0,0,0,0,0,0,2,1,1,8,2,6,2,0,271,248,113
"2074","Jarrad Branthwaite",19,"2002","06","27","2020/2021","Midfielder","Everton",0,0,0,"England",0,0,0,0,0,0,0,0,0,0,0,0,0,0,0,0,0,0,0,-1,-1,-1
"2075","Jarrod Bowen",24,"1996","12","20","2020/2021","Forward","West Ham United",2578,1401,1177,"England",38,19,19,8,6,2,5,2,3,0,0,11,6,5,33,16,17,0,0,59,80,-1
"2076","Jason Steele",31,"1990","08","18","2020/2021","Goalkeeper","Brighton & Hove Albion",0,0,0,"England",0,0,0,0,0,0,0,0,0,0,0,0,0,0,0,0,0,0,0,-1,-1,-1
"2077","Javier Manquillo Gaitán",27,"1994","05","05","2020/2021","Defender","Newcastle United",826,305,521,"Spain",13,7,6,0,0,0,0,0,0,0,0,3,0,3,14,8,6,1,0,322,302,118
"2078","Jay Rodriguez",32,"1989","07","29","2020/2021","Forward","Burnley",1254,607,647,"England",31,14,17,1,0,1,2,1,1,0,0,9,2,7,24,11,13,3,0,188,104,-1
"2079","Jayden Bogle",21,"2000","07","27","2020/2021","Defender","Sheffield United",1109,540,569,"England",16,6,10,2,1,1,0,0,0,0,0,2,2,0,19,8,11,2,0,111,251,119
"2080","Jayson Molumby",22,"1999","08","06","2020/2021","Midfielder","Brighton & Hove Albion",0,0,0,"Republic of Ireland",1,0,1,0,0,0,0,0,0,0,0,0,0,0,0,0,0,0,0,-1,-1,-1
"2081","Jean-Philippe Gbamin",26,"1995","09","25","2020/2021","Midfielder","Everton",11,11,0,"Côte d'Ivoire",1,1,0,0,0,0,0,0,0,0,0,0,0,0,1,1,0,0,0,-1,-1,-1
"2082","Jean-Philippe Mateta",24,"1997","06","28","2020/2021","Forward","Crystal Palace",217,36,181,"France",7,2,5,1,0,1,0,0,0,0,0,0,0,0,4,0,4,0,0,-1,-1,-1
"2083","Jed Steer",29,"1992","09","22","2020/2021","Goalkeeper","Aston Villa",0,0,0,"England",0,0,0,0,0,0,0,0,0,0,0,0,0,0,0,0,0,0,0,-1,-1,-1
"2084","Jeff Hendrick",29,"1992","01","31","2020/2021","Midfielder","Newcastle United",1423,560,863,"Republic of Ireland",22,7,15,2,0,2,1,0,1,0,0,5,0,5,22,12,10,3,1,126,194,-1
"2085","Jeffrey Schlupp",28,"1992","12","23","2020/2021","Defender","Crystal Palace",1425,845,580,"Ghana",27,14,13,2,2,0,3,1,2,0,0,5,4,1,23,14,9,3,0,125,62,110
"2086","Jensen Weir",19,"2002","01","01","2020/2021","Midfielder","Brighton & Hove Albion",0,0,0,"England",0,0,0,0,0,0,0,0,0,0,0,0,0,0,0,0,0,0,0,-1,-1,-1
"2087","Jesse Lingard",28,"1992","12","15","2020/2021","Midfielder","West Ham United",1426,709,717,"England",16,8,8,9,5,4,4,1,3,1,1,4,3,1,18,7,11,3,0,11,26,-1
"2088","Jesuran Rak-Sakyi",0,"1970","01","01","2020/2021","Forward","Crystal Palace",0,0,0,"England",0,0,0,0,0,0,0,0,0,0,0,0,0,0,0,0,0,0,0,-1,-1,-1
"2089","Jimmy Dunne",24,"1997","10","19","2020/2021","Defender","Burnley",270,90,180,"Republic of Ireland",3,1,2,1,0,1,0,0,0,0,0,0,0,0,6,1,5,1,0,-1,-1,-1
"2090","Joachim Andersen",25,"1996","05","31","2020/2021","Defender","Fulham",2730,1350,1380,"Denmark",31,15,16,1,1,0,1,0,1,0,0,9,5,4,32,17,15,8,1,259,236,42
"2091","João Cancelo",27,"1994","05","27","2020/2021","Defender","Manchester City",2302,1074,1228,"Portugal",28,13,15,2,0,2,3,0,3,0,0,15,7,8,15,7,8,6,1,168,116,3
"2092","João Manuel Neves Virginia",22,"1999","10","10","2020/2021","Goalkeeper","Everton",47,47,0,"Portugal",1,1,0,0,0,0,0,0,0,0,0,0,0,0,0,0,0,0,0,-1,-1,-1
"2093","João Moutinho",35,"1986","09","08","2020/2021","Midfielder","Wolverhampton Wanderers",2533,1176,1357,"Portugal",33,16,17,1,1,0,1,0,1,0,0,10,5,5,36,15,21,5,1,241,219,-1
"2094","Joe Bryan",28,"1993","09","17","2020/2021","Defender","Fulham",662,370,292,"England",16,8,8,1,0,1,0,0,0,0,0,2,1,1,16,9,7,2,0,122,416,156
"2095","Joe Gelhardt",19,"2002","05","04","2020/2021","Midfielder","Leeds United",0,0,0,"England",0,0,0,0,0,0,0,0,0,0,0,0,0,0,0,0,0,0,0,-1,-1,-1
"2096","Joe Gomez",24,"1997","05","23","2020/2021","Defender","Liverpool",590,360,230,"England",7,4,3,0,0,0,0,0,0,0,0,0,0,0,14,6,8,0,0,359,352,154
"2097","Joe Hart",34,"1987","04","19","2020/2021","Goalkeeper","Tottenham Hotspur",0,0,0,"England",0,0,0,0,0,0,0,0,0,0,0,0,0,0,0,0,0,0,0,-1,-1,-1
"2098","Joe Rodon",24,"1997","10","22","2020/2021","Defender","Tottenham Hotspur",729,189,540,"Wales",12,4,8,0,0,0,0,0,0,0,0,5,2,3,11,5,6,0,0,272,255,98
"2099","Joel Matip",30,"1991","08","08","2020/2021","Defender","Liverpool",693,331,362,"Cameroon",10,5,5,1,1,0,2,1,1,0,0,3,2,1,5,1,4,2,0,133,23,7
"2100","Joel Mumbongo",22,"1999","01","09","2020/2021","Forward","Burnley",36,22,14,"Sweden",4,3,1,0,0,0,0,0,0,0,0,1,1,0,1,0,1,1,0,-1,-1,-1
"2101","Joël Veltman",29,"1992","01","15","2020/2021","Defender","Brighton & Hove Albion",2281,1281,1000,"Netherlands",28,15,13,1,1,0,1,1,0,0,0,10,7,3,26,11,15,3,0,246,218,39
"2102","Joel Ward",32,"1989","10","29","2020/2021","Defender","Crystal Palace",2255,1085,1170,"England",26,13,13,0,0,0,1,0,1,0,0,8,6,2,40,14,26,5,0,340,212,129
"2103","Joelinton Cassio Apolinário de Lira",25,"1996","08","14","2020/2021","Forward","Newcastle United",1989,1152,837,"Brazil",31,16,15,4,3,1,2,1,1,1,0,5,2,3,36,19,17,3,0,97,149,-1
"2104","Johann Berg Guðmunds­son",31,"1990","10","27","2020/2021","Midfielder","Burnley",1368,774,594,"Iceland",22,12,10,2,1,1,0,0,0,0,0,4,1,3,24,14,10,2,0,134,288,-1
"2105","John Egan",29,"1992","10","20","2020/2021","Defender","Sheffield United",2630,1350,1280,"Republic of Ireland",31,15,16,0,0,0,1,1,0,0,0,4,3,1,46,21,25,8,1,409,229,121
"2106","John Fleck",30,"1991","08","24","2020/2021","Midfielder","Sheffield United",2577,1340,1237,"Scotland",31,15,16,0,0,0,2,1,1,0,0,5,4,1,45,22,23,4,0,410,168,-1
"2107","John Lundstram",27,"1994","02","18","2020/2021","Midfielder","Sheffield United",2032,1095,937,"England",28,16,12,0,0,0,2,1,1,0,1,3,3,0,39,18,21,9,1,412,145,-1
"2108","John McGinn",27,"1994","10","18","2020/2021","Midfielder","Aston Villa",3330,1620,1710,"Scotland",37,18,19,3,2,1,5,1,4,0,0,14,6,8,43,27,16,12,0,172,99,-1
"2109","John Ruddy",35,"1986","10","24","2020/2021","Goalkeeper","Wolverhampton Wanderers",90,0,90,"England",2,1,1,0,0,0,0,0,0,0,0,0,0,0,1,0,1,0,0,-1,-1,-1
"2110","John Stones",27,"1994","05","28","2020/2021","Defender","Manchester City",1934,990,944,"England",22,11,11,4,3,1,0,0,0,0,0,14,8,6,10,4,6,1,1,89,244,1
"2111","Jonas Lössl",32,"1989","02","01","2020/2021","Goalkeeper","Everton",0,0,0,"Denmark",0,0,0,0,0,0,0,0,0,0,0,0,0,0,0,0,0,0,0,-1,-1,-1
"2112","Jonjo Shelvey",29,"1992","02","27","2020/2021","Midfielder","Newcastle United",2617,1357,1260,"England",30,16,14,1,1,0,3,1,2,0,0,6,1,5,44,26,18,7,0,254,139,-1
"2113","Jonjoe Kenny",24,"1997","03","15","2020/2021","Defender","Everton",76,0,76,"England",4,2,2,0,0,0,0,0,0,0,0,2,1,1,1,0,1,0,0,-1,-1,-1
"2114","Jonny",27,"1994","03","03","2020/2021","Defender","Wolverhampton Wanderers",501,196,305,"Spain",7,3,4,0,0,0,0,0,0,0,0,3,2,1,4,1,3,0,0,264,284,9
"2115","Jonny Evans",33,"1988","01","03","2020/2021","Defender","Leicester City",2476,1329,1147,"Northern Ireland",28,15,13,2,1,1,2,1,1,0,0,10,6,4,30,17,13,7,0,190,170,49
"2116","Jordan Ayew",30,"1991","09","11","2020/2021","Forward","Crystal Palace",2097,1017,1080,"Ghana",33,16,17,1,1,0,3,2,1,0,0,8,6,2,40,16,24,4,0,233,106,-1
"2117","Jordan Henderson",31,"1990","06","17","2020/2021","Midfielder","Liverpool",1707,807,900,"England",21,10,11,1,0,1,1,1,0,0,0,5,2,3,22,12,10,0,0,222,198,-1
"2118","Jordan Pickford",27,"1994","03","07","2020/2021","Goalkeeper","Everton",2743,1483,1260,"England",31,17,14,0,0,0,0,0,0,0,0,10,3,7,36,22,14,1,0,399,398,70
"2119","Jorginho",29,"1991","12","20","2020/2021","Midfielder","Chelsea",2013,1118,895,"Italy",28,14,14,7,4,3,1,0,1,7,2,14,7,7,16,11,5,2,0,49,216,-1
"2120","Jose Izquierdo",29,"1992","07","07","2020/2021","Forward","Brighton & Hove Albion",8,0,8,"Colombia",1,0,1,0,0,0,0,0,0,0,0,0,0,0,0,0,0,0,0,-1,-1,-1
"2121","Joseph Willock",22,"1999","08","20","2020/2021","Midfielder","Newcastle United",1214,604,610,"England",21,10,11,8,5,3,0,0,0,0,1,5,1,4,18,11,7,1,0,9,340,-1
"2122","Josh Benson",21,"1999","12","05","2020/2021","Midfielder","Burnley",261,97,164,"England",6,4,2,0,0,0,0,0,0,0,0,1,1,0,7,1,6,0,0,-1,-1,-1
"2123","Josh Brownhill",25,"1995","12","19","2020/2021","Midfielder","Burnley",2816,1422,1394,"England",33,17,16,0,0,0,1,0,1,0,0,10,3,7,42,22,20,2,0,380,223,-1
"2124","Josh Maja",22,"1998","12","27","2020/2021","Forward","Fulham",810,311,499,"England",15,7,8,3,0,3,0,0,0,1,0,5,2,3,8,3,5,0,0,45,293,-1
"2125","Josh Onomah",24,"1997","04","27","2020/2021","Forward","Fulham",370,217,153,"England",11,5,6,0,0,0,0,0,0,0,0,1,0,1,12,5,7,1,0,341,332,-1
"2126","Joshua King",29,"1992","01","15","2020/2021","Forward","Everton",137,93,44,"Norway",11,6,5,0,0,0,0,0,0,0,0,3,1,2,2,2,0,0,0,-1,-1,-1
"2127","Juan Mata",33,"1988","04","28","2020/2021","Midfielder","Manchester United",510,212,298,"Spain",9,4,5,1,0,1,2,0,2,1,0,2,2,0,6,2,4,0,0,95,8,-1
"2128","Kai Havertz",22,"1999","06","11","2020/2021","Midfielder","Chelsea",1521,767,754,"Germany",27,15,12,4,3,1,3,1,2,0,0,12,8,4,13,4,9,2,0,72,63,-1
"2129","Kaine Hayden",0,"1970","01","01","2020/2021","Midfielder","Aston Villa",0,0,0,"England",0,0,0,0,0,0,0,0,0,0,0,0,0,0,0,0,0,0,0,-1,-1,-1
"2130","Kaine Kessler",0,"1970","01","01","2020/2021","Forward","Aston Villa",0,0,0,"England",0,0,0,0,0,0,0,0,0,0,0,0,0,0,0,0,0,0,0,-1,-1,-1
"2131","Kalvin Phillips",25,"1995","12","02","2020/2021","Midfielder","Leeds United",2430,1258,1172,"England",29,15,14,1,1,0,2,0,2,0,0,10,5,5,32,13,19,10,0,247,177,-1
"2132","Kamil Grosicki",33,"1988","06","08","2020/2021","Forward","West Bromwich Albion",149,0,149,"Poland",3,0,3,0,0,0,1,0,1,0,0,0,0,0,5,0,5,0,0,-1,-1,-1
"2133","Karl Darlow",31,"1990","10","08","2020/2021","Goalkeeper","Newcastle United",2250,1080,1170,"England",25,12,13,0,0,0,0,0,0,0,0,4,1,3,40,18,22,3,0,320,311,127
"2134","Karlan Ahearne-Grant",23,"1997","12","19","2020/2021","Forward","West Bromwich Albion",1133,588,545,"England",21,11,10,1,0,1,0,0,0,0,0,3,3,0,25,15,10,1,0,176,249,-1
"2135","Karlo Ziger",20,"2001","05","11","2020/2021","Goalkeeper","Chelsea",0,0,0,"Croatia",0,0,0,0,0,0,0,0,0,0,0,0,0,0,0,0,0,0,0,-1,-1,-1
"2136","Kasper Schmeichel",35,"1986","11","05","2020/2021","Goalkeeper","Leicester City",3420,1710,1710,"Denmark",38,19,19,0,0,0,0,0,0,0,0,11,6,5,48,28,20,0,0,333,326,84
"2137","Kayne Ramsey",21,"2000","10","10","2020/2021","Midfielder","Southampton",90,0,90,"England",1,0,1,0,0,0,0,0,0,0,0,0,0,0,7,0,7,1,0,-1,-1,-1
"2138","Kean Bryan",25,"1996","11","01","2020/2021","Midfielder","Sheffield United",1007,621,386,"England",13,8,5,1,0,1,0,0,0,0,0,2,2,0,16,8,8,1,0,165,264,-1
"2139","Keinan Davis",23,"1998","02","13","2020/2021","Midfielder","Aston Villa",264,239,25,"England",15,9,6,1,1,0,1,1,0,0,0,4,4,0,1,1,0,0,0,-1,-1,-1
"2140","Kelechi Iheanacho",25,"1996","10","03","2020/2021","Forward","Leicester City",1456,748,708,"Nigeria",25,13,12,12,6,6,2,1,1,0,1,7,4,3,22,13,9,1,0,2,115,-1
"2141","Kenny Tete",26,"1995","10","09","2020/2021","Defender","Fulham",1483,709,774,"Netherlands",22,11,11,0,0,0,1,0,1,0,0,6,2,4,26,14,12,3,0,369,197,122
"2142","Kepa Arrizabalaga",27,"1994","10","03","2020/2021","Goalkeeper","Chelsea",584,450,134,"Spain",7,5,2,0,0,0,0,0,0,0,0,2,2,0,7,5,2,1,0,379,365,48
"2143","Kevin De Bruyne",30,"1991","06","28","2020/2021","Midfielder","Manchester City",2001,1192,809,"Belgium",25,14,11,6,4,2,12,8,4,2,1,12,7,5,17,13,4,1,0,63,2,-1
"2144","Kevin Long",31,"1990","08","18","2020/2021","Defender","Burnley",636,360,276,"Republic of Ireland",8,4,4,0,0,0,0,0,0,0,0,2,0,2,13,6,7,2,0,367,384,148
"2145","Kgagelo Chauke",18,"2003","01","08","2020/2021","Midfielder","Southampton",0,0,0,"England",0,0,0,0,0,0,0,0,0,0,0,0,0,0,0,0,0,0,0,-1,-1,-1
"2146","Ki-Jana Hoever",19,"2002","01","18","2020/2021","Defender","Wolverhampton Wanderers",571,172,399,"Netherlands",12,5,7,0,0,0,0,0,0,0,0,3,2,1,7,2,5,1,0,294,277,51
"2147","Kieran Gibbs",32,"1989","09","26","2020/2021","Defender","West Bromwich Albion",809,360,449,"England",10,4,6,0,0,0,0,0,0,0,0,0,0,0,21,13,8,2,1,329,318,159
"2148","Kieran Tierney",24,"1997","06","05","2020/2021","Defender","Arsenal",2301,1053,1248,"Scotland",27,13,14,1,0,1,3,1,2,0,0,8,2,6,27,13,14,4,0,236,124,45
"2149","Kiko Casilla",35,"1986","10","02","2020/2021","Goalkeeper","Leeds United",270,180,90,"Spain",3,2,1,0,0,0,0,0,0,0,0,1,0,1,1,1,0,0,0,-1,-1,-1
"2150","Konstantinos Tsimikas",25,"1996","05","12","2020/2021","Defender","Liverpool",5,5,0,"Greece",2,1,1,0,0,0,0,0,0,0,0,1,0,1,0,0,0,0,0,-1,-1,-1
"2151","Kortney Hause",26,"1995","07","16","2020/2021","Defender","Aston Villa",630,270,360,"England",7,3,4,1,1,0,0,0,0,0,0,3,2,1,6,1,5,2,0,123,360,18
"2152","Kurt Zouma",27,"1994","10","27","2020/2021","Defender","Chelsea",2027,1172,855,"France",24,14,10,5,2,3,0,0,0,0,0,9,6,3,22,14,8,3,0,79,367,34
"2153","Kyle Alex John",20,"2001","02","13","2020/2021","Midfielder","Everton",0,0,0,"England",0,0,0,0,0,0,0,0,0,0,0,0,0,0,0,0,0,0,0,-1,-1,-1
"2154","Kyle Bartley",30,"1991","05","22","2020/2021","Defender","West Bromwich Albion",2583,1323,1260,"England",30,16,14,3,3,0,1,0,1,0,0,5,4,1,49,21,28,4,0,150,230,139
"2155","Kyle Edwards",23,"1998","02","17","2020/2021","Midfielder","West Bromwich Albion",113,22,91,"England",5,2,3,0,0,0,0,0,0,0,0,0,0,0,3,2,1,0,0,-1,-1,-1
"2156","Kyle Walker",31,"1990","05","28","2020/2021","Defender","Manchester City",1946,968,978,"England",24,13,11,1,0,1,1,1,0,0,0,10,6,4,20,10,10,1,0,227,208,25
"2157","Kyle Walker-Peters",24,"1997","04","13","2020/2021","Defender","Southampton",2649,1422,1227,"England",30,16,14,0,0,0,2,2,0,0,0,9,6,3,34,18,16,4,0,357,175,65
"2158","Kyron Gordon",19,"2002","05","24","2020/2021","Defender","Sheffield United",0,0,0,"England",0,0,0,0,0,0,0,0,0,0,0,0,0,0,0,0,0,0,0,-1,-1,-1
"2159","Leander Dendoncker",26,"1995","04","15","2020/2021","Midfielder","Wolverhampton Wanderers",2501,1231,1270,"Belgium",33,18,15,1,1,0,0,0,0,0,0,10,5,5,30,16,14,4,0,240,414,-1
"2160","Leandro Trossard",26,"1994","12","04","2020/2021","Forward","Brighton & Hove Albion",2620,1360,1260,"Belgium",35,18,17,5,4,1,5,3,2,0,0,11,6,5,28,14,14,2,0,103,78,-1
"2161","Lee Grant",38,"1983","01","27","2020/2021","Goalkeeper","Manchester United",0,0,0,"England",0,0,0,0,0,0,0,0,0,0,0,0,0,0,0,0,0,0,0,-1,-1,-1
"2162","Lee Peltier",34,"1986","12","11","2020/2021","Defender","West Bromwich Albion",229,136,93,"England",4,2,2,0,0,0,0,0,0,0,0,0,0,0,8,6,2,1,0,-1,-1,-1
"2163","Leif Davis",21,"2000","01","12","2020/2021","Defender","Leeds United",31,13,18,"England",2,1,1,0,0,0,0,0,0,0,0,0,0,0,0,0,0,0,0,-1,-1,-1
"2164","Leighton Clarkson",20,"2001","10","19","2020/2021","Midfielder","Liverpool",0,0,0,"England",0,0,0,0,0,0,0,0,0,0,0,0,0,0,0,0,0,0,0,-1,-1,-1
"2165","Lewis Dunk",29,"1991","11","21","2020/2021","Defender","Brighton & Hove Albion",2933,1350,1583,"England",33,15,18,5,1,4,0,0,0,0,0,11,6,5,36,16,20,7,2,116,375,50
"2166","Lewis Richards",0,"1970","01","01","2020/2021","Defender","Wolverhampton Wanderers",0,0,0,"England",0,0,0,0,0,0,0,0,0,0,0,0,0,0,0,0,0,0,0,-1,-1,-1
"2167","Lewis Richardson",18,"2003","02","07","2020/2021","Forward","Burnley",3,0,3,"England",2,0,2,0,0,0,0,0,0,0,0,0,0,0,0,0,0,0,0,-1,-1,-1
"2168","Liam Cooper",30,"1991","08","30","2020/2021","Defender","Leeds United",2187,1170,1017,"Scotland",25,13,12,1,0,1,0,0,0,0,0,6,3,3,37,16,21,5,1,235,372,116
"2169","Liam Delap",0,"1970","01","01","2020/2021","Midfielder","Manchester City",39,39,0,"England",1,1,0,0,0,0,0,0,0,0,0,0,0,0,4,4,0,0,0,-1,-1,-1
"2170","Liam Hughes",20,"2001","08","19","2020/2021","Goalkeeper","Liverpool",0,0,0,"Northern Ireland",0,0,0,0,0,0,0,0,0,0,0,0,0,0,0,0,0,0,0,-1,-1,-1
"2171","Lucas Digne",28,"1993","07","20","2020/2021","Defender","Everton",2682,1350,1332,"France",30,15,15,0,0,0,7,2,5,0,0,9,2,7,39,22,17,3,1,401,36,90
"2172","Lucas Rodrigues Moura da Silva",29,"1992","08","13","2020/2021","Midfielder","Tottenham Hotspur",1401,690,711,"Brazil",30,13,17,3,2,1,4,2,2,0,0,10,5,5,16,8,8,1,0,90,19,-1
"2173","Luka Milivojević",30,"1991","04","07","2020/2021","Midfielder","Crystal Palace",2364,1069,1295,"Serbia",31,14,17,1,1,0,1,0,1,1,1,8,6,2,44,21,23,9,1,237,213,-1
"2174","Luke Ayling",30,"1991","08","25","2020/2021","Defender","Leeds United",3400,1690,1710,"England",38,19,19,0,0,0,0,0,0,0,0,12,6,6,51,19,32,7,0,352,345,94
"2175","Luke Cundle",0,"1970","01","01","2020/2021","Midfielder","Wolverhampton Wanderers",0,0,0,"England",0,0,0,0,0,0,0,0,0,0,0,0,0,0,0,0,0,0,0,-1,-1,-1
"2176","Luke Mbete-Tatu",18,"2003","09","18","2020/2021","Defender","Manchester City",0,0,0,"England",0,0,0,0,0,0,0,0,0,0,0,0,0,0,0,0,0,0,0,-1,-1,-1
"2177","Luke Shaw",26,"1995","07","12","2020/2021","Defender","Manchester United",2655,1328,1327,"England",32,17,15,1,0,1,5,3,2,0,0,12,5,7,30,21,9,8,0,255,77,38
"2178","Luke Thomas",0,"1970","01","01","2020/2021","Midfielder","Leicester City",971,409,562,"England",14,7,7,1,0,1,0,0,0,0,0,2,2,0,17,9,8,2,0,166,358,-1
"2179","Lys Mousset",25,"1996","02","08","2020/2021","Forward","Sheffield United",289,80,209,"France",11,4,7,0,0,0,0,0,0,0,0,0,0,0,10,2,8,0,0,283,265,-1
"2180","Mace Lewin Goodridge",22,"1999","09","13","2020/2021","Midfielder","Burnley",0,0,0,"England",0,0,0,0,0,0,0,0,0,0,0,0,0,0,0,0,0,0,0,-1,-1,-1
"2181","Mahmoud Ibrahim Hassan",27,"1994","10","01","2020/2021","Midfielder","Aston Villa",1166,657,509,"Egypt",21,12,9,2,2,0,1,1,0,0,0,9,4,5,14,11,3,0,0,115,162,-1
"2182","Mamadou Sakho",31,"1990","02","13","2020/2021","Defender","Crystal Palace",275,90,185,"France",4,1,3,0,0,0,0,0,0,0,0,0,0,0,7,2,5,0,0,373,378,158
"2183","Manuel Lanzini",28,"1993","02","15","2020/2021","Midfielder","West Ham United",558,331,227,"Argentina",17,9,8,1,0,1,1,1,0,0,0,6,3,3,5,4,1,1,0,108,89,-1
"2184","Marc Albrighton",31,"1989","11","18","2020/2021","Midfielder","Leicester City",1741,886,855,"England",31,15,16,1,1,0,5,2,3,0,0,11,6,5,22,12,10,2,0,228,20,-1
"2185","Marcos Alonso",30,"1990","12","28","2020/2021","Defender","Chelsea",960,526,434,"Spain",13,7,6,2,1,1,0,0,0,0,0,6,5,1,12,6,6,2,0,87,366,59
"2186","Marcus Rashford",24,"1997","10","31","2020/2021","Forward","Manchester United",2927,1497,1430,"England",37,19,18,11,5,6,9,2,7,0,0,13,6,7,35,23,12,4,0,43,14,-1
"2187","Marek Rodák",24,"1996","12","13","2020/2021","Goalkeeper","Fulham",180,180,0,"Slovakia",2,2,0,0,0,0,0,0,0,0,0,0,0,0,5,5,0,0,0,-1,-1,-1
"2188","Mario Lemina",28,"1993","09","01","2020/2021","Midfielder","Fulham",1704,872,832,"Gabon",28,14,14,1,0,1,0,0,0,0,0,7,4,3,25,14,11,5,0,226,373,-1
"2189","Mark Gillespie",29,"1992","03","27","2020/2021","Goalkeeper","Newcastle United",0,0,0,"England",0,0,0,0,0,0,0,0,0,0,0,0,0,0,0,0,0,0,0,-1,-1,-1
"2190","Mark Noble",34,"1987","05","08","2020/2021","Midfielder","West Ham United",705,343,362,"England",21,12,9,0,0,0,0,0,0,0,0,6,3,3,14,6,8,1,0,318,307,-1
"2191","Martin Dúbravka",32,"1989","01","15","2020/2021","Goalkeeper","Newcastle United",1170,630,540,"Slovakia",13,7,6,0,0,0,0,0,0,0,0,3,1,2,19,12,7,0,0,265,268,111
"2192","Martin Kelly",31,"1990","04","27","2020/2021","Defender","Crystal Palace",1,0,1,"England",1,0,1,0,0,0,0,0,0,0,0,0,0,0,0,0,0,0,0,-1,-1,-1
"2193","Martin Ødegaard",22,"1998","12","17","2020/2021","Midfielder","Arsenal",866,440,426,"Norway",14,7,7,1,1,0,2,1,1,0,0,4,2,2,12,8,4,0,0,149,49,-1
"2194","Marvelous Nakamba",27,"1994","01","19","2020/2021","Midfielder","Aston Villa",749,433,316,"Zimbabwe",13,6,7,0,0,0,0,0,0,0,0,7,3,4,6,3,3,3,0,388,299,-1
"2195","Mason Greenwood",20,"2001","10","01","2020/2021","Midfielder","Manchester United",1824,1043,781,"England",31,16,15,7,4,3,2,1,1,0,0,12,5,7,22,15,7,2,0,41,137,-1
"2196","Mason Holgate",25,"1996","10","22","2020/2021","Defender","Everton",2289,1181,1108,"England",28,15,13,1,0,1,0,0,0,0,0,11,3,8,31,19,12,9,0,231,262,78
"2197","Mason Mount",22,"1999","01","10","2020/2021","Midfielder","Chelsea",2891,1363,1528,"England",36,18,18,6,1,5,5,3,2,1,0,17,9,8,30,14,16,2,0,92,86,-1
"2198","Matěj Vydra",29,"1992","05","01","2020/2021","Forward","Burnley",1366,792,574,"Czech Republic",28,13,15,3,2,1,2,0,2,0,0,6,1,5,23,13,10,0,0,86,108,-1
"2199","Mateo Kovačić",27,"1994","05","06","2020/2021","Midfielder","Chelsea",1820,959,861,"Croatia",27,14,13,0,0,0,1,1,0,0,0,12,8,4,24,11,13,4,0,375,202,-1
"2200","Mateusz Bogusz",20,"2001","08","22","2020/2021","Midfielder","Leeds United",0,0,0,"Poland",0,0,0,0,0,0,0,0,0,0,0,0,0,0,0,0,0,0,0,-1,-1,-1
"2201","Mateusz Klich",31,"1990","06","13","2020/2021","Midfielder","Leeds United",2399,1219,1180,"Poland",35,18,17,4,2,2,5,2,3,2,0,11,6,5,42,17,25,6,0,118,61,-1
"2202","Matheus Fellipe Costa Pereira",25,"1996","05","05","2020/2021","Forward","West Bromwich Albion",2582,1400,1182,"Brazil",33,17,16,11,3,8,6,2,4,4,0,6,5,1,51,25,26,3,1,36,48,-1
"2203","Mathew Ryan",29,"1992","04","08","2020/2021","Goalkeeper","Arsenal",1260,630,630,"Australia",14,7,7,0,0,0,0,0,0,0,0,3,1,2,20,10,10,1,0,417,405,106
"2204","Matt Doherty",29,"1992","01","16","2020/2021","Defender","Tottenham Hotspur",1238,564,674,"Republic of Ireland",17,9,8,0,0,0,2,1,1,0,0,6,3,3,13,6,7,4,1,339,90,32
"2205","Matt Macey",27,"1994","09","09","2020/2021","Goalkeeper","Arsenal",0,0,0,"England",0,0,0,0,0,0,0,0,0,0,0,0,0,0,0,0,0,0,0,-1,-1,-1
"2206","Matt Phillips",30,"1991","03","13","2020/2021","Midfielder","West Bromwich Albion",1828,936,892,"Scotland",33,18,15,2,1,1,1,0,1,0,0,6,5,1,38,21,17,1,0,153,210,-1
"2207","Matt Ritchie",32,"1989","09","10","2020/2021","Midfielder","Newcastle United",1352,818,534,"Scotland",18,10,8,0,0,0,2,1,1,0,0,4,2,2,22,15,7,2,0,327,107,-1
"2208","Matt Targett",26,"1995","09","18","2020/2021","Defender","Aston Villa",3405,1710,1695,"England",38,19,19,0,0,0,2,1,1,0,0,15,7,8,42,27,15,7,0,384,200,53
"2209","Matthew Longstaff",21,"2000","03","21","2020/2021","Midfielder","Newcastle United",377,180,197,"England",5,2,3,0,0,0,0,0,0,0,0,1,1,0,8,2,6,0,0,288,261,-1
"2210","Matthew Lowton",32,"1989","06","09","2020/2021","Defender","Burnley",3060,1620,1440,"England",34,18,16,1,0,1,1,0,1,0,0,10,3,7,46,26,20,5,0,249,225,96
"2211","Matty Cash",24,"1997","08","07","2020/2021","Midfielder","Aston Villa",2378,1149,1229,"England",28,14,14,0,0,0,2,0,2,0,0,12,5,7,33,22,11,8,1,385,157,-1
"2212","Max Harrison Sanders",22,"1999","01","04","2020/2021","Midfielder","Brighton & Hove Albion",0,0,0,"England",0,0,0,0,0,0,0,0,0,0,0,0,0,0,0,0,0,0,0,-1,-1,-1
"2213","Max Kilman",24,"1997","05","23","2020/2021","Defender","Wolverhampton Wanderers",1306,630,676,"England",18,7,11,0,0,0,1,0,1,0,0,5,3,2,10,4,6,4,0,390,174,8
"2214","Max Lowe",24,"1997","05","11","2020/2021","Defender","Sheffield United",552,372,180,"England",8,6,2,0,0,0,0,0,0,0,0,0,0,0,10,5,5,1,0,285,297,135
"2215","Max Meyer",26,"1995","09","18","2020/2021","Midfielder","Crystal Palace",0,0,0,"Germany",0,0,0,0,0,0,0,0,0,0,0,0,0,0,0,0,0,0,0,-1,-1,-1
"2216","Max Thompson",19,"2002","02","09","2020/2021","Midfielder","Burnley",0,0,0,"England",0,0,0,0,0,0,0,0,0,0,0,0,0,0,0,0,0,0,0,-1,-1,-1
"2217","Maxime Le Marchand",32,"1989","10","11","2020/2021","Defender","Fulham",122,32,90,"France",2,1,1,0,0,0,0,0,0,0,0,0,0,0,1,0,1,2,0,-1,-1,-1
"2218","Mbaye Diagne",30,"1991","10","28","2020/2021","Forward","West Bromwich Albion",1193,558,635,"Senegal",16,8,8,3,2,1,2,2,0,0,0,4,3,1,16,4,12,2,0,76,92,-1
"2219","Meritan Shabani",22,"1999","03","15","2020/2021","Midfielder","Wolverhampton Wanderers",0,0,0,"Kosovo",0,0,0,0,0,0,0,0,0,0,0,0,0,0,0,0,0,0,0,-1,-1,-1
"2220","Michael Hector",29,"1992","07","19","2020/2021","Defender","Fulham",264,148,116,"Jamaica",4,2,2,0,0,0,0,0,0,0,0,0,0,0,10,6,4,2,0,-1,-1,-1
"2221","Michael Keane",28,"1993","01","11","2020/2021","Defender","Everton",2990,1474,1516,"England",35,17,18,3,2,1,1,0,1,0,0,11,3,8,40,21,19,4,0,159,234,76
"2222","Michael Obafemi",21,"2000","07","06","2020/2021","Forward","Southampton",57,14,43,"Republic of Ireland",4,1,3,0,0,0,0,0,0,0,0,1,0,1,1,0,1,0,0,-1,-1,-1
"2223","Michael Verrips",24,"1996","12","03","2020/2021","Goalkeeper","Sheffield United",0,0,0,"Netherlands",0,0,0,0,0,0,0,0,0,0,0,0,0,0,0,0,0,0,0,-1,-1,-1
"2224","Michail Antonio",31,"1990","03","28","2020/2021","Midfielder","West Ham United",1984,958,1026,"England",26,12,14,10,4,6,5,2,3,0,0,8,4,4,25,12,13,3,0,27,34,-1
"2225","Michał Karbownik",20,"2001","03","13","2020/2021","Midfielder","Brighton & Hove Albion",0,0,0,"Poland",0,0,0,0,0,0,0,0,0,0,0,0,0,0,0,0,0,0,0,-1,-1,-1
"2226","Michy Batshuayi",28,"1993","10","02","2020/2021","Forward","Crystal Palace",722,292,430,"Belgium",18,7,11,2,1,1,1,0,1,0,0,1,1,0,13,6,7,0,0,66,112,-1
"2227","Miguel Ángel Almirón Rejala",27,"1994","02","10","2020/2021","Midfielder","Newcastle United",2437,1166,1271,"Paraguay",34,17,17,4,4,0,1,0,1,0,0,6,2,4,46,20,26,3,0,117,214,-1
"2228","Miguel Azeez",0,"1970","01","01","2020/2021","Forward","Arsenal",0,0,0,"England",0,0,0,0,0,0,0,0,0,0,0,0,0,0,0,0,0,0,0,-1,-1,-1
"2229","Mohamed Elneny",29,"1992","07","11","2020/2021","Midfielder","Arsenal",1542,763,779,"Egypt",23,12,11,1,0,1,0,0,0,0,0,7,1,6,20,13,7,3,0,203,338,-1
"2230","Mohamed Saïd Benrahma",26,"1995","08","10","2020/2021","Forward","West Ham United",1388,691,697,"Algeria",30,15,15,1,0,1,6,3,3,0,0,8,5,3,18,9,9,0,0,210,6,-1
"2231","Mohamed Salah",29,"1992","06","15","2020/2021","Forward","Liverpool",3082,1532,1550,"Egypt",37,18,19,22,9,13,5,3,2,6,0,11,4,7,40,19,21,0,0,6,96,-1
"2232","Mohamed Salisu Abdul Karim",22,"1999","04","17","2020/2021","Defender","Southampton",841,418,423,"Ghana",12,7,5,0,0,0,0,0,0,0,0,0,0,0,17,4,13,1,0,281,260,147
"2233","Moise Kean",21,"2000","02","28","2020/2021","Forward","Everton",13,12,1,"Italy",2,1,1,0,0,0,0,0,0,0,0,1,0,1,0,0,0,0,0,-1,-1,-1
"2234","Moisés Isaac Caicedo Corozo",20,"2001","02","11","2020/2021","Forward","Brighton & Hove Albion",0,0,0,"Ecuador",0,0,0,0,0,0,0,0,0,0,0,0,0,0,0,0,0,0,0,-1,-1,-1
"2235","Morgan Gibbs-White",21,"2000","01","27","2020/2021","Midfielder","Wolverhampton Wanderers",410,243,167,"England",11,7,4,1,1,0,0,0,0,0,0,2,1,1,6,3,3,1,0,77,295,-1
"2236","Morgan Sanson",27,"1994","08","18","2020/2021","Midfielder","Aston Villa",291,213,78,"France",9,5,4,0,0,0,0,0,0,0,0,3,1,2,3,3,0,3,0,277,290,-1
"2237","Moussa Djenepo",23,"1998","06","15","2020/2021","Midfielder","Southampton",1239,724,515,"Mali",27,13,14,1,1,0,0,0,0,0,0,7,4,3,24,10,14,5,0,180,348,-1
"2238","Moussa Sissoko",32,"1989","08","16","2020/2021","Midfielder","Tottenham Hotspur",1575,738,837,"France",25,12,13,0,0,0,0,0,0,0,0,9,4,5,19,9,10,3,0,397,395,-1
"2239","N'Golo Kanté",30,"1991","03","29","2020/2021","Midfielder","Chelsea",2145,953,1192,"France",30,14,16,0,0,0,2,1,1,0,0,14,7,7,22,10,12,7,0,368,159,-1
"2240","Naby Deco Keïta",26,"1995","02","10","2020/2021","Midfielder","Liverpool",524,291,233,"Guinea",10,5,5,0,0,0,0,0,0,0,0,6,2,4,8,4,4,1,0,360,354,-1
"2241","Nampalys Mendy",29,"1992","06","23","2020/2021","Midfielder","Leicester City",1457,679,778,"France",23,12,11,0,0,0,1,0,1,0,0,5,2,3,24,15,9,5,0,334,192,-1
"2242","Nathan Aké",26,"1995","02","18","2020/2021","Defender","Manchester City",797,508,289,"Netherlands",10,6,4,1,1,0,0,0,0,0,0,3,2,1,12,8,4,4,0,147,242,100
"2243","Nathan Bishop",22,"1999","10","15","2020/2021","Goalkeeper","Manchester United",0,0,0,"England",0,0,0,0,0,0,0,0,0,0,0,0,0,0,0,0,0,0,0,-1,-1,-1
"2244","Nathan Broadhead",23,"1998","04","05","2020/2021","Forward","Everton",2,0,2,"Wales",1,0,1,0,0,0,0,0,0,0,0,1,0,1,0,0,0,0,0,-1,-1,-1
"2245","Nathan Redmond",27,"1994","03","06","2020/2021","Midfielder","Southampton",1731,881,850,"England",29,15,14,2,2,0,3,3,0,0,0,5,4,1,34,11,23,1,0,155,85,-1
"2246","Nathan Tella",22,"1999","07","05","2020/2021","Midfielder","Southampton",741,328,413,"England",18,8,10,1,1,0,1,1,0,0,0,3,1,2,11,5,6,2,0,139,120,-1
"2247","Nathan Trott",22,"1998","11","21","2020/2021","Goalkeeper","West Ham United",0,0,0,"England",0,0,0,0,0,0,0,0,0,0,0,0,0,0,0,0,0,0,0,-1,-1,-1
"2248","Nathaniel Clyne",30,"1991","04","05","2020/2021","Defender","Crystal Palace",1147,625,522,"England",13,7,6,0,0,0,1,0,1,0,0,1,1,0,21,14,7,2,0,275,153,136
"2249","Nathaniel Phillips",24,"1997","03","21","2020/2021","Defender","Liverpool",1454,600,854,"England",17,7,10,1,0,1,1,0,1,0,0,7,2,5,10,5,5,2,0,213,185,6
"2250","Neal Maupay",25,"1996","08","14","2020/2021","Forward","Brighton & Hove Albion",2519,1275,1244,"France",33,17,16,8,3,5,2,1,1,3,1,11,7,4,31,13,18,2,1,57,172,-1
"2251","Neco Williams",20,"2001","04","13","2020/2021","Midfielder","Liverpool",248,180,68,"Wales",6,3,3,0,0,0,0,0,0,0,0,2,2,0,1,1,0,1,0,-1,-1,-1
"2252","Neeskens Kebano",29,"1992","03","10","2020/2021","Midfielder","Fulham",116,75,41,"Congo DR",5,3,2,0,0,0,0,0,0,0,0,1,1,0,3,3,0,0,0,-1,-1,-1
"2253","Neil Taylor",32,"1989","02","07","2020/2021","Defender","Aston Villa",15,0,15,"Wales",1,0,1,0,0,0,0,0,0,0,0,0,0,0,1,0,1,1,0,-1,-1,-1
"2254","Nélson Semedo",27,"1993","11","16","2020/2021","Defender","Wolverhampton Wanderers",2988,1480,1508,"Portugal",34,17,17,1,1,0,1,0,1,0,0,9,5,4,42,19,23,5,0,250,239,85
"2255","Nemanja Matić",33,"1988","08","01","2020/2021","Midfielder","Manchester United",1099,553,546,"Serbia",20,9,11,0,0,0,0,0,0,0,0,5,2,3,16,10,6,2,0,280,285,-1
"2256","Niall Huggins",20,"2000","12","18","2020/2021","Forward","Leeds United",37,0,37,"Wales",1,0,1,0,0,0,0,0,0,0,0,0,0,0,0,0,0,0,0,-1,-1,-1
"2257","Nick Pope",29,"1992","04","19","2020/2021","Goalkeeper","Burnley",2880,1440,1440,"England",32,16,16,0,0,0,0,0,0,0,0,11,3,8,37,18,19,1,0,376,382,67
"2258","Nicolas Otamendi",33,"1988","02","12","2020/2021","Defender","Manchester City",0,0,0,"Argentina",0,0,0,0,0,0,0,0,0,0,0,0,0,0,0,0,0,0,0,-1,-1,-1
"2259","Nicolas Pépé",26,"1995","09","29","2020/2021","Forward","Arsenal",1612,810,802,"Côte d'Ivoire",29,15,14,10,4,6,1,0,1,1,0,7,3,4,21,11,10,2,1,13,189,-1
"2260","Niels Nkounkou",21,"2000","11","01","2020/2021","Defender","Everton",81,0,81,"France",2,0,2,0,0,0,0,0,0,0,0,0,0,0,1,0,1,1,0,-1,-1,-1
"2261","Nigel Lonwijk",19,"2002","10","27","2020/2021","Defender","Wolverhampton Wanderers",0,0,0,"Netherlands",0,0,0,0,0,0,0,0,0,0,0,0,0,0,0,0,0,0,0,-1,-1,-1
"2262","Nile John",18,"2003","03","06","2020/2021","Midfielder","Tottenham Hotspur",0,0,0,"England",0,0,0,0,0,0,0,0,0,0,0,0,0,0,0,0,0,0,0,-1,-1,-1
"2263","Odion Jude Ighalo",32,"1989","06","16","2020/2021","Forward","Manchester United",9,9,0,"Nigeria",1,1,0,0,0,0,0,0,0,0,0,0,0,0,1,1,0,0,0,-1,-1,-1
"2264","Okay Yokuşlu",27,"1994","03","09","2020/2021","Midfielder","West Bromwich Albion",1319,677,642,"Turkey",16,8,8,0,0,0,1,1,0,0,0,4,3,1,18,6,12,4,0,282,178,-1
"2265","Ola Aina",25,"1996","10","08","2020/2021","Defender","Fulham",2671,1222,1449,"Nigeria",31,14,17,2,1,1,1,0,1,0,0,8,4,4,34,17,17,3,0,194,240,64
"2266","Oleksandr Zinchenko",24,"1996","12","15","2020/2021","Midfielder","Manchester City",1474,873,601,"Ukraine",20,11,9,0,0,0,0,0,0,0,0,10,6,4,11,6,5,0,0,303,274,-1
"2267","Oliver Burke",24,"1997","04","07","2020/2021","Midfielder","Sheffield United",1270,686,584,"Scotland",25,13,12,1,0,1,1,1,0,0,0,3,3,0,21,12,9,2,0,181,171,-1
"2268","Oliver Casey",21,"2000","10","14","2020/2021","Defender","Leeds United",0,0,0,"England",0,0,0,0,0,0,0,0,0,0,0,0,0,0,0,0,0,0,0,-1,-1,-1
"2269","Oliver McBurnie",25,"1996","06","04","2020/2021","Forward","Sheffield United",1316,798,518,"Scotland",23,13,10,1,1,0,0,0,0,0,0,1,1,0,25,14,11,2,0,177,406,-1
"2270","Oliver Norwood",30,"1991","04","12","2020/2021","Midfielder","Sheffield United",2226,1211,1015,"Northern Ireland",32,18,14,0,0,0,0,0,0,0,0,5,4,1,42,20,22,6,0,411,391,-1
"2271","Olivier Giroud",35,"1986","09","30","2020/2021","Forward","Chelsea",746,415,331,"France",17,10,7,4,3,1,0,0,0,0,0,8,5,3,5,2,3,1,0,25,370,-1
"2272","Ollie Watkins",25,"1995","12","30","2020/2021","Forward","Aston Villa",3329,1619,1710,"England",37,18,19,14,8,6,5,3,2,1,1,14,6,8,43,27,16,4,1,37,102,-1
"2273","Oluwasemilogo Adesewo Ibidapo Ajayi",28,"1993","11","09","2020/2021","Defender","West Bromwich Albion",2779,1265,1514,"Nigeria",33,15,18,2,0,2,0,0,0,0,0,3,2,1,67,36,31,4,1,211,319,155
"2274","Oluwatosin Adarabioyo",24,"1997","09","24","2020/2021","Defender","Fulham",2954,1424,1530,"England",33,16,17,0,0,0,0,0,0,0,0,9,5,4,39,21,18,1,0,270,245,73
"2275","Onyinye Wilfred Ndidi",24,"1996","12","16","2020/2021","Midfielder","Leicester City",2179,1216,963,"Nigeria",26,14,12,1,1,0,4,2,2,0,0,7,5,2,30,18,12,6,0,239,74,-1
"2276","Oriol Romeu",30,"1991","09","24","2020/2021","Midfielder","Southampton",1767,950,817,"Spain",21,11,10,1,1,0,1,1,0,0,0,6,5,1,22,9,13,6,0,221,205,-1
"2277","Oskar Buur",23,"1998","03","31","2020/2021","Defender","Wolverhampton Wanderers",22,0,22,"Denmark",1,0,1,0,0,0,0,0,0,0,0,1,0,1,0,0,0,0,0,-1,-1,-1
"2278","Owen Otasowie",0,"1970","01","01","2020/2021","Midfielder","Wolverhampton Wanderers",185,51,134,"England",6,2,4,0,0,0,1,1,0,0,0,0,0,0,4,1,3,1,0,-1,-1,-1
"2279","Ozan Muhammed Kabak",21,"2000","03","25","2020/2021","Defender","Liverpool",803,359,444,"Turkey",9,4,5,0,0,0,0,0,0,0,0,3,0,3,8,4,4,3,0,274,266,22
"2280","Pablo Fornals Malla",25,"1996","02","22","2020/2021","Midfielder","West Ham United",2583,1220,1363,"Spain",33,16,17,5,2,3,4,3,1,0,0,9,5,4,31,11,20,3,0,106,100,-1
"2281","Pablo Hernández Domínguez",36,"1985","04","11","2020/2021","Midfielder","Leeds United",417,264,153,"Spain",16,10,6,0,0,0,2,2,0,0,0,4,2,2,5,2,3,1,0,326,3,-1
"2282","Pablo Marí Villar",28,"1993","08","31","2020/2021","Defender","Arsenal",900,270,630,"Spain",10,3,7,0,0,0,0,0,0,0,0,4,0,4,8,3,5,2,0,266,252,13
"2283","Pascal Groß",30,"1991","06","15","2020/2021","Midfielder","Brighton & Hove Albion",2482,1307,1175,"Germany",34,17,17,3,3,0,8,3,5,3,1,11,7,4,26,11,15,3,0,144,13,-1
"2284","Pascal Struijk",22,"1999","08","11","2020/2021","Defender","Leeds United",2074,959,1115,"Netherlands",27,12,15,1,0,1,0,0,0,0,0,9,5,4,31,7,24,3,0,242,315,97
"2285","Patrick Bamford",28,"1993","09","05","2020/2021","Forward","Leeds United",3062,1531,1531,"England",38,19,19,17,7,10,7,2,5,2,0,12,6,6,47,18,29,3,0,19,46,-1
"2286","Patrick Cutrone",23,"1998","01","03","2020/2021","Forward","Wolverhampton Wanderers",23,23,0,"Italy",2,2,0,0,0,0,0,0,0,0,0,0,0,0,0,0,0,0,0,-1,-1,-1
"2287","Patrick van Aanholt",31,"1990","08","29","2020/2021","Defender","Crystal Palace",1776,900,876,"Netherlands",22,10,12,0,0,0,1,0,1,0,0,4,4,0,34,17,17,2,0,276,209,141
"2288","Paul Dummett",30,"1991","09","26","2020/2021","Defender","Newcastle United",1256,642,614,"Wales",15,8,7,1,0,1,0,0,0,0,0,3,1,2,20,12,8,2,0,178,254,108
"2289","Paul Pogba",28,"1993","03","15","2020/2021","Midfielder","Manchester United",1896,1032,864,"France",26,13,13,3,0,3,3,2,1,0,0,7,3,4,25,17,8,3,0,121,98,-1
"2290","Pedro Lomba Neto",21,"2000","03","09","2020/2021","Forward","Wolverhampton Wanderers",2559,1244,1315,"Portugal",31,15,16,5,3,2,6,4,2,0,0,9,4,5,34,15,19,4,0,98,50,-1
"2291","Percy Tau",27,"1994","05","13","2020/2021","Midfielder","Brighton & Hove Albion",102,17,85,"South Africa",3,1,2,0,0,0,1,1,0,0,0,1,0,1,2,1,1,0,0,-1,-1,-1
"2292","Phil Bardsley",36,"1985","06","28","2020/2021","Defender","Burnley",273,90,183,"Scotland",4,1,3,0,0,0,0,0,0,0,0,1,0,1,8,1,7,2,0,377,383,160
"2293","Phil Jagielka",39,"1982","08","17","2020/2021","Defender","Sheffield United",526,171,355,"England",10,5,5,0,0,0,0,0,0,0,0,3,3,0,11,4,7,2,1,414,409,151
"2294","Philip Foden",21,"2000","05","28","2020/2021","Midfielder","Manchester City",1611,860,751,"England",28,16,12,9,2,7,5,3,2,0,0,12,9,3,14,6,8,0,0,20,16,-1
"2295","Pierre-Emerick Aubameyang",32,"1989","06","18","2020/2021","Forward","Arsenal",2337,1135,1202,"Gabon",29,13,16,10,6,4,3,1,2,2,0,10,3,7,26,15,11,2,0,32,122,-1
"2296","Pierre-Emile Højbjerg",26,"1995","08","05","2020/2021","Midfielder","Tottenham Hotspur",3420,1710,1710,"Denmark",38,19,19,2,2,0,4,2,2,0,0,12,7,5,40,17,23,9,0,217,127,-1
"2297","Raheem Sterling",26,"1994","12","08","2020/2021","Forward","Manchester City",2537,1250,1287,"England",31,15,16,10,4,6,7,4,3,0,1,16,8,8,20,12,8,4,0,40,28,-1
"2298","Raphael Dias Belloli",25,"1996","02","14","2020/2021","Forward","Leeds United",2363,1085,1278,"Brazil",30,14,16,6,2,4,9,3,6,0,0,10,5,5,32,9,23,3,0,73,9,-1
"2299","Raúl Alonso Jiménez Rodríguez",30,"1991","05","05","2020/2021","Forward","Wolverhampton Wanderers",825,450,375,"Mexico",10,5,5,4,2,2,0,0,0,0,0,4,2,2,8,4,4,0,0,29,415,-1
"2300","Rayan Aït Nouri",20,"2001","06","06","2020/2021","Defender","Wolverhampton Wanderers",1405,762,643,"France",21,11,10,1,1,0,1,1,0,0,0,5,3,2,22,13,9,1,0,212,187,104
"2301","Reda Jousef Khadra",20,"2001","07","04","2020/2021","Midfielder","Brighton & Hove Albion",4,0,4,"Germany",1,0,1,0,0,0,0,0,0,0,0,0,0,0,0,0,0,0,0,-1,-1,-1
"2302","Reece Hannam",21,"2000","09","19","2020/2021","Defender","Crystal Palace",0,0,0,"England",0,0,0,0,0,0,0,0,0,0,0,0,0,0,0,0,0,0,0,-1,-1,-1
"2303","Reece James",21,"1999","12","08","2020/2021","Defender","Chelsea",2366,976,1390,"England",32,14,18,1,0,1,2,1,1,0,0,14,7,7,26,10,16,3,0,238,161,35
"2304","Reece Welch",18,"2003","09","19","2020/2021","Defender","Everton",0,0,0,"England",0,0,0,0,0,0,0,0,0,0,0,0,0,0,0,0,0,0,0,-1,-1,-1
"2305","Reiss Nelson",21,"1999","12","10","2020/2021","Forward","Arsenal",69,25,44,"England",2,1,1,0,0,0,0,0,0,0,0,1,0,1,0,0,0,0,0,-1,-1,-1
"2306","Rekeem Harper",21,"2000","03","08","2020/2021","Midfielder","West Bromwich Albion",30,30,0,"England",2,2,0,0,0,0,0,0,0,0,0,0,0,0,2,2,0,0,0,-1,-1,-1
"2307","Rhian Brewster",21,"2000","04","01","2020/2021","Forward","Sheffield United",1124,535,589,"England",27,14,13,0,0,0,0,0,0,0,0,4,4,0,15,6,9,1,0,269,247,-1
"2308","Rhys Williams",20,"2001","02","03","2020/2021","Defender","Liverpool",660,390,270,"England",9,5,4,0,0,0,0,0,0,0,0,4,2,2,6,3,3,0,0,267,256,15
"2309","Ricardo Domingos Barbosa Pereira",28,"1993","10","06","2020/2021","Defender","Leicester City",959,410,549,"Portugal",15,8,7,0,0,0,1,0,1,0,0,4,2,2,18,12,6,3,0,291,150,138
"2310","Richard Nartey",23,"1998","09","06","2020/2021","Defender","Burnley",0,0,0,"England",0,0,0,0,0,0,0,0,0,0,0,0,0,0,0,0,0,0,0,-1,-1,-1
"2311","Richarlison de Andrade",24,"1997","05","10","2020/2021","Forward","Everton",2872,1555,1317,"Brazil",34,18,16,7,3,4,3,2,1,1,0,11,3,8,37,22,15,5,1,78,142,-1
"2312","Riyad Mahrez",30,"1991","02","21","2020/2021","Midfielder","Manchester City",1955,852,1103,"Algeria",27,12,15,9,7,2,6,3,3,0,0,14,7,7,21,11,10,0,0,31,15,-1
"2313","Rob Holding",26,"1995","09","20","2020/2021","Defender","Arsenal",2557,1297,1260,"England",30,16,14,0,0,0,1,0,1,0,0,11,4,7,26,14,12,2,0,347,215,26
"2314","Robbie Brady",29,"1992","01","14","2020/2021","Midfielder","Burnley",1055,451,604,"Republic of Ireland",19,9,10,1,1,0,1,1,0,0,0,8,2,6,6,3,3,3,0,162,140,-1
"2315","Robert Lynch Sanchez",23,"1997","11","18","2020/2021","Goalkeeper","Brighton & Hove Albion",2430,1170,1260,"Spain",27,13,14,0,0,0,0,0,0,0,0,10,6,4,25,11,14,2,0,299,257,28
"2316","Robert Snodgrass",34,"1987","09","07","2020/2021","Midfielder","West Bromwich Albion",529,250,279,"Scotland",11,5,6,0,0,0,0,0,0,0,0,0,0,0,14,8,6,2,0,295,246,-1
"2317","Roberto Firmino",30,"1991","10","02","2020/2021","Forward","Liverpool",2852,1409,1443,"Brazil",36,18,18,9,3,6,7,2,5,0,0,11,5,6,37,18,19,2,0,58,40,-1
"2318","Robin Koch",25,"1996","07","17","2020/2021","Defender","Leeds United",1129,553,576,"Germany",17,8,9,0,0,0,0,0,0,0,0,5,2,3,20,9,11,1,0,338,329,124
"2319","Robin Olsen",31,"1990","01","08","2020/2021","Goalkeeper","Everton",630,180,450,"Sweden",7,2,5,0,0,0,0,0,0,0,0,2,0,2,9,3,6,1,0,297,296,86
"2320","Rodri",25,"1996","06","22","2020/2021","Midfielder","Manchester City",2748,1128,1620,"Spain",34,16,18,2,1,1,2,1,1,1,0,17,9,8,25,11,14,6,0,187,181,-1
"2321","Rodrigo",30,"1991","03","06","2020/2021","Forward","Leeds United",1288,609,679,"Spain",26,12,14,7,4,3,2,0,2,0,0,9,3,6,20,7,13,3,0,23,101,-1
"2322","Romain Saïss",31,"1990","03","26","2020/2021","Midfielder","Wolverhampton Wanderers",2408,1238,1170,"Morocco",27,14,13,3,1,2,0,0,0,0,0,7,3,4,34,19,15,2,0,141,413,-1
"2323","Romaine Theodore Sawyers",30,"1991","11","02","2020/2021","Midfielder","West Bromwich Albion",1490,699,791,"St. Kitts and Nevis",19,9,10,0,0,0,0,0,0,0,0,2,2,0,41,24,17,2,0,332,322,-1
"2324","Ross Barkley",27,"1993","12","05","2020/2021","Midfielder","Aston Villa",1577,893,684,"England",26,15,11,3,1,2,1,0,1,0,0,8,4,4,22,18,4,0,0,107,186,-1
"2325","Rúben Diogo Da Silva Neves",24,"1997","03","13","2020/2021","Midfielder","Wolverhampton Wanderers",2680,1403,1277,"Portugal",36,18,18,5,2,3,1,0,1,3,0,9,4,5,38,21,17,8,0,102,238,-1
"2326","Rúben Gonçalo Silva Nascimento Vinagre",22,"1999","04","09","2020/2021","Defender","Wolverhampton Wanderers",172,82,90,"Portugal",2,1,1,0,0,0,0,0,0,0,0,0,0,0,5,2,3,0,0,-1,-1,-1
"2327","Ruben Loftus-Cheek",25,"1996","01","23","2020/2021","Midfielder","Fulham",1973,964,1009,"England",31,15,16,1,1,0,0,0,0,0,0,8,4,4,20,11,9,3,0,215,369,-1
"2328","Rúben Santos Gato Alves Dias",24,"1997","05","14","2020/2021","Defender","Manchester City",2845,1420,1425,"Portugal",32,16,16,1,1,0,0,0,0,0,0,17,9,8,19,9,10,4,0,258,282,5
"2329","Rui Pedro dos Santos Patrício",33,"1988","02","15","2020/2021","Goalkeeper","Wolverhampton Wanderers",3330,1710,1620,"Portugal",37,19,18,0,0,0,0,0,0,0,0,10,5,5,45,23,22,1,0,415,410,79
"2330","Rúnar Alex Rúnarsson",26,"1995","02","18","2020/2021","Goalkeeper","Arsenal",16,0,16,"Iceland",1,0,1,0,0,0,0,0,0,0,0,0,0,0,0,0,0,0,0,-1,-1,-1
"2331","Ryan Astley",20,"2001","10","04","2020/2021","Midfielder","Everton",0,0,0,"Wales",0,0,0,0,0,0,0,0,0,0,0,0,0,0,0,0,0,0,0,-1,-1,-1
"2332","Ryan Bertrand",32,"1989","08","05","2020/2021","Defender","Southampton",2599,1170,1429,"England",29,13,16,0,0,0,1,0,1,0,0,8,5,3,47,16,31,5,0,355,231,132
"2333","Ryan Finnigan",0,"1970","01","01","2020/2021","Midfielder","Southampton",0,0,0,"England",0,0,0,0,0,0,0,0,0,0,0,0,0,0,0,0,0,0,0,-1,-1,-1
"2334","Ryan Fraser",27,"1994","02","24","2020/2021","Midfielder","Newcastle United",925,408,517,"Scotland",18,9,9,0,0,0,2,1,1,0,0,2,0,2,14,7,7,2,1,325,58,-1
"2335","Ryan Fredericks",29,"1992","10","10","2020/2021","Midfielder","West Ham United",564,275,289,"England",14,7,7,1,1,0,1,0,1,0,0,4,2,2,8,5,3,2,0,112,88,-1
"2336","Ryan Inniss",26,"1995","06","05","2020/2021","Defender","Crystal Palace",0,0,0,"England",0,0,0,0,0,0,0,0,0,0,0,0,0,0,0,0,0,0,0,-1,-1,-1
"2337","Sadio Mané",29,"1992","04","10","2020/2021","Forward","Liverpool",2812,1472,1340,"Senegal",35,18,17,11,5,6,7,1,6,0,0,12,5,7,26,16,10,3,0,39,39,-1
"2338","Sam Field",23,"1998","05","08","2020/2021","Midfielder","West Bromwich Albion",59,0,59,"England",3,1,2,0,0,0,0,0,0,0,0,0,0,0,1,0,1,0,0,-1,-1,-1
"2339","Sam Greenwood",0,"1970","01","01","2020/2021","Defender","Leeds United",0,0,0,"England",0,0,0,0,0,0,0,0,0,0,0,0,0,0,0,0,0,0,0,-1,-1,-1
"2340","Sam Johnstone",28,"1993","03","25","2020/2021","Goalkeeper","West Bromwich Albion",3330,1710,1620,"England",37,19,18,0,0,0,1,0,1,0,0,6,5,1,70,37,33,1,0,328,235,152
"2341","Sam Woods",23,"1998","09","11","2020/2021","Defender","Crystal Palace",0,0,0,"England",0,0,0,0,0,0,0,0,0,0,0,0,0,0,0,0,0,0,0,-1,-1,-1
"2342","Sander Berge",23,"1998","02","14","2020/2021","Midfielder","Sheffield United",1119,535,584,"Norway",15,8,7,1,0,1,1,0,1,1,0,0,0,0,22,6,16,4,0,174,160,-1
"2343","Scott Carson",36,"1985","09","03","2020/2021","Goalkeeper","Manchester City",90,0,90,"England",1,0,1,0,0,0,0,0,0,0,0,0,0,0,3,0,3,0,0,-1,-1,-1
"2344","Scott Dann",34,"1987","02","14","2020/2021","Defender","Crystal Palace",1350,540,810,"England",15,6,9,1,1,0,0,0,0,0,0,2,2,0,22,7,15,1,0,193,342,112
"2345","Scott McTominay",24,"1996","12","08","2020/2021","Midfielder","Manchester United",2125,1076,1049,"England",32,16,16,4,4,0,1,1,0,0,0,13,6,7,23,15,8,3,0,100,222,-1
"2346","Sead Kolašinac",28,"1993","06","20","2020/2021","Defender","Arsenal",90,90,0,"Bosnia and Herzegovina",1,1,0,0,0,0,0,0,0,0,0,0,0,0,1,1,0,0,0,-1,-1,-1
"2347","Séamus Coleman",33,"1988","10","11","2020/2021","Defender","Everton",1612,969,643,"Republic of Ireland",25,16,9,0,0,0,3,2,1,0,0,8,1,7,17,16,1,0,0,400,72,33
"2348","Sean Longstaff",24,"1997","10","30","2020/2021","Midfielder","Newcastle United",1405,735,670,"England",22,11,11,0,0,0,1,1,0,0,0,4,1,3,24,11,13,2,0,314,196,-1
"2349","Sébastien Haller",27,"1994","06","22","2020/2021","Forward","West Ham United",934,450,484,"France",16,8,8,3,2,1,0,0,0,0,0,6,2,4,12,7,5,0,0,55,308,-1
"2350","Serge Aurier",28,"1992","12","24","2020/2021","Defender","Tottenham Hotspur",1609,979,630,"Côte d'Ivoire",19,12,7,2,0,2,3,2,1,0,0,6,5,1,19,10,9,0,0,142,75,46
"2351","Sergio Aguero",33,"1988","06","02","2020/2021","Forward","Manchester City",559,266,293,"Argentina",12,7,5,4,2,2,1,1,0,1,1,6,3,3,3,2,1,0,0,7,82,-1
"2352","Sergio Reguilón Rodríguez",24,"1996","12","16","2020/2021","Defender","Tottenham Hotspur",2249,1170,1079,"Spain",27,13,14,0,0,0,3,3,0,0,0,8,5,3,28,12,16,5,0,309,121,54
"2353","Shane Flynn",0,"1970","01","01","2020/2021","Midfielder","Leicester City",0,0,0,"Republic of Ireland",0,0,0,0,0,0,0,0,0,0,0,0,0,0,0,0,0,0,0,-1,-1,-1
"2354","Shane Long",34,"1987","01","22","2020/2021","Forward","Southampton",201,68,133,"Republic of Ireland",11,5,6,0,0,0,0,0,0,0,0,4,3,1,2,2,0,0,0,-1,-1,-1
"2355","Shkodran Mustafi",29,"1992","04","17","2020/2021","Defender","Arsenal",44,41,3,"Germany",3,2,1,0,0,0,0,0,0,0,0,1,0,1,1,1,0,0,0,-1,-1,-1
"2356","Shola Shoretire",0,"1970","01","01","2020/2021","Forward","Manchester United",9,1,8,"Nigeria",2,1,1,0,0,0,0,0,0,0,0,0,0,0,0,0,0,0,0,-1,-1,-1
"2357","Sidnei Tavares",0,"1970","01","01","2020/2021","Midfielder","Leicester City",85,0,85,"England",2,0,2,0,0,0,0,0,0,0,0,0,0,0,1,0,1,0,0,-1,-1,-1
"2358","Solomon March",27,"1994","07","20","2020/2021","Midfielder","Brighton & Hove Albion",1675,812,863,"England",21,10,11,2,1,1,1,0,1,0,0,6,2,4,24,12,12,0,0,140,201,-1
"2359","Stefan Marius Johansen",30,"1991","01","08","2020/2021","Midfielder","Fulham",0,0,0,"Norway",0,0,0,0,0,0,0,0,0,0,0,0,0,0,0,0,0,0,0,-1,-1,-1
"2360","Stephen Henderson",33,"1988","05","02","2020/2021","Goalkeeper","Crystal Palace",0,0,0,"Republic of Ireland",0,0,0,0,0,0,0,0,0,0,0,0,0,0,0,0,0,0,0,-1,-1,-1
"2361","Steven Alzate",23,"1998","09","08","2020/2021","Midfielder","Brighton & Hove Albion",897,442,455,"England",15,8,7,1,0,1,0,0,0,0,0,4,1,3,16,10,6,2,0,156,363,-1
"2362","Steven Bergwijn",24,"1997","10","08","2020/2021","Forward","Tottenham Hotspur",1211,659,552,"Netherlands",21,12,9,1,1,0,3,2,1,0,0,7,5,2,13,6,7,3,0,189,38,-1
"2363","Stuart Armstrong",29,"1992","03","30","2020/2021","Midfielder","Southampton",2774,1379,1395,"Scotland",33,17,16,4,4,0,5,3,2,0,0,9,6,3,48,19,29,3,0,130,83,-1
"2364","Stuart Dallas",30,"1991","04","19","2020/2021","Midfielder","Leeds United",3411,1701,1710,"Northern Ireland",38,19,19,8,4,4,2,1,1,0,0,12,6,6,51,19,32,7,0,83,203,-1
"2365","Sylvester Jasper",20,"2001","09","13","2020/2021","Forward","Fulham",0,0,0,"England",0,0,0,0,0,0,0,0,0,0,0,0,0,0,0,0,0,0,0,-1,-1,-1
"2366","Takumi Minamino",26,"1995","01","16","2020/2021","Forward","Southampton",1003,459,544,"Japan",19,10,9,3,1,2,0,0,0,0,0,4,1,3,17,7,10,1,0,62,356,-1
"2367","Tammy Abraham",24,"1997","10","02","2020/2021","Forward","Chelsea",1035,464,571,"England",22,11,11,6,3,3,1,0,1,0,0,12,7,5,10,1,9,0,0,16,148,-1
"2368","Tanguy Ndombele",24,"1996","12","28","2020/2021","Midfielder","Tottenham Hotspur",2108,948,1160,"France",33,16,17,3,0,3,2,1,1,0,0,10,5,5,23,9,14,3,0,132,144,-1
"2369","Tariq Lamptey",21,"2000","09","30","2020/2021","Midfielder","Brighton & Hove Albion",891,450,441,"England",11,5,6,1,0,1,1,1,0,0,0,3,1,2,14,8,6,4,1,152,135,-1
"2370","Tawanda Jethro Maswanhise",18,"2002","11","20","2020/2021","Midfielder","Leicester City",0,0,0,"England",0,0,0,0,0,0,0,0,0,0,0,0,0,0,0,0,0,0,0,-1,-1,-1
"2371","Taylor Gardner-Hickman",0,"1970","01","01","2020/2021","Forward","West Bromwich Albion",0,0,0,"England",0,0,0,0,0,0,0,0,0,0,0,0,0,0,0,0,0,0,0,-1,-1,-1
"2372","Taylor Harwood-Bellis",19,"2002","01","30","2020/2021","Defender","Manchester City",0,0,0,"England",0,0,0,0,0,0,0,0,0,0,0,0,0,0,0,0,0,0,0,-1,-1,-1
"2373","Taylor Perry",20,"2001","07","15","2020/2021","Midfielder","Wolverhampton Wanderers",0,0,0,"England",0,0,0,0,0,0,0,0,0,0,0,0,0,0,0,0,0,0,0,-1,-1,-1
"2374","Teddy Hoare",0,"1970","01","01","2020/2021","Midfielder","Brighton & Hove Albion",0,0,0,"England",0,0,0,0,0,0,0,0,0,0,0,0,0,0,0,0,0,0,0,-1,-1,-1
"2375","Terence Kongolo",27,"1994","02","14","2020/2021","Defender","Fulham",90,90,0,"Netherlands",1,1,0,0,0,0,0,0,0,0,0,0,0,0,0,0,0,0,0,-1,-1,-1
"2376","Thakgalo Khanya Leshabela",22,"1999","09","18","2020/2021","Midfielder","Leicester City",9,9,0,"Cameroon",1,1,0,0,0,0,0,0,0,0,0,1,1,0,0,0,0,0,0,-1,-1,-1
"2377","Thanawat Suengchitthawon",21,"2000","01","08","2020/2021","Midfielder","Leicester City",0,0,0,"France",0,0,0,0,0,0,0,0,0,0,0,0,0,0,0,0,0,0,0,-1,-1,-1
"2378","Theo Corbeanu",19,"2002","05","17","2020/2021","Midfielder","Wolverhampton Wanderers",8,0,8,"Romania",1,0,1,0,0,0,0,0,0,0,0,0,0,0,0,0,0,0,0,-1,-1,-1
"2379","Theo Walcott",32,"1989","03","16","2020/2021","Forward","Southampton",1641,850,791,"England",22,12,10,3,1,2,3,2,1,0,0,5,4,1,23,10,13,0,0,109,84,-1
"2380","Thiago Alcantara",30,"1991","04","11","2020/2021","Midfielder","Liverpool",1857,782,1075,"Spain",24,10,14,1,1,0,0,0,0,0,0,9,3,6,18,6,12,4,0,218,381,-1
"2381","Thiago Silva",37,"1984","09","22","2020/2021","Defender","Chelsea",1938,1019,919,"Brazil",23,12,11,2,2,0,0,0,0,0,0,11,6,5,19,7,12,5,1,163,270,20
"2382","Thomas Doyle",20,"2001","10","17","2020/2021","Midfielder","Manchester City",0,0,0,"England",0,0,0,0,0,0,0,0,0,0,0,0,0,0,0,0,0,0,0,-1,-1,-1
"2383","Thomas McGill",21,"2000","03","25","2020/2021","Goalkeeper","Brighton & Hove Albion",0,0,0,"England",0,0,0,0,0,0,0,0,0,0,0,0,0,0,0,0,0,0,0,-1,-1,-1
"2384","Thomas Partey",28,"1993","06","13","2020/2021","Midfielder","Arsenal",1535,710,825,"Ghana",24,11,13,0,0,0,2,1,1,0,0,8,4,4,17,7,10,5,0,310,113,-1
"2385","Tim Iroegbunam",0,"1970","01","01","2020/2021","Midfielder","West Bromwich Albion",0,0,0,"England",0,0,0,0,0,0,0,0,0,0,0,0,0,0,0,0,0,0,0,-1,-1,-1
"2386","Tim Ream",34,"1987","10","05","2020/2021","Defender","Fulham",630,360,270,"USA",7,4,3,0,0,0,0,0,0,0,0,0,0,0,13,10,3,0,0,312,300,149
"2387","Timo Werner",25,"1996","03","06","2020/2021","Forward","Chelsea",2607,1294,1313,"Germany",35,17,18,6,4,2,8,5,3,0,0,17,9,8,27,14,13,2,0,80,18,-1
"2388","Timothy Castagne",25,"1995","12","05","2020/2021","Defender","Leicester City",2346,1206,1140,"Belgium",27,14,13,2,1,1,3,2,1,0,0,7,4,3,35,21,14,1,0,175,114,93
"2389","Timothy Fosu-Mensah",23,"1998","01","02","2020/2021","Defender","Manchester United",81,81,0,"Netherlands",1,1,0,0,0,0,0,0,0,0,0,0,0,0,2,2,0,1,0,-1,-1,-1
"2390","Toby Alderweireld",32,"1989","03","02","2020/2021","Defender","Tottenham Hotspur",2241,1341,900,"Belgium",25,15,10,1,1,0,0,0,0,0,0,10,7,3,23,11,12,2,0,243,392,24
"2391","Toby King",0,"1970","01","01","2020/2021","Midfielder","West Bromwich Albion",0,0,0,"England",0,0,0,0,0,0,0,0,0,0,0,0,0,0,0,0,0,0,0,-1,-1,-1
"2392","Tom Cairney",30,"1991","01","20","2020/2021","Midfielder","Fulham",759,418,341,"Scotland",10,5,5,1,1,0,1,1,0,0,0,1,1,0,13,11,2,2,0,136,111,-1
"2393","Tom Davies",23,"1998","06","30","2020/2021","Midfielder","Everton",1424,798,626,"England",25,12,13,0,0,0,1,1,0,0,0,8,2,6,22,12,10,3,0,404,195,-1
"2394","Tom Heaton",35,"1986","04","15","2020/2021","Goalkeeper","Aston Villa",0,0,0,"England",0,0,0,0,0,0,0,0,0,0,0,0,0,0,0,0,0,0,0,-1,-1,-1
"2395","Tomáš Souček",26,"1995","02","27","2020/2021","Midfielder","West Ham United",3420,1710,1710,"Czech Republic",38,19,19,10,4,6,1,1,0,0,0,11,6,5,45,21,24,8,1,64,233,-1
"2396","Trent Alexander-Arnold",23,"1998","10","07","2020/2021","Defender","Liverpool",3033,1475,1558,"England",36,18,18,2,1,1,7,1,6,0,0,11,4,7,39,18,21,2,0,207,47,69
"2397","Tyler Onyango",18,"2003","03","04","2020/2021","Midfielder","Everton",0,0,0,"England",0,0,0,0,0,0,0,0,0,0,0,0,0,0,0,0,0,0,0,-1,-1,-1
"2398","Tyler Roberts",22,"1999","01","12","2020/2021","Forward","Leeds United",1338,752,586,"Wales",27,15,12,1,0,1,2,1,1,0,0,6,3,3,17,9,8,3,0,191,109,-1
"2399","Tyrese Francois",21,"2000","07","16","2020/2021","Midfielder","Fulham",14,14,0,"Australia",1,1,0,0,0,0,0,0,0,0,0,0,0,0,1,1,0,0,0,-1,-1,-1
"2400","Tyrick Mitchell",22,"1999","09","01","2020/2021","Defender","Crystal Palace",1710,810,900,"England",19,9,10,1,1,0,1,1,0,0,0,4,2,2,28,11,17,1,0,216,199,114
"2401","Tyrone Mings",28,"1993","03","13","2020/2021","Defender","Aston Villa",3195,1665,1530,"England",36,19,17,2,1,1,2,2,0,0,0,15,7,8,39,27,12,6,1,205,191,52
"2402","Valentino Livramento",19,"2002","11","12","2020/2021","Defender","Chelsea",0,0,0,"England",0,0,0,0,0,0,0,0,0,0,0,0,0,0,0,0,0,0,0,-1,-1,-1
"2403","Vicente Guaita",34,"1987","01","10","2020/2021","Goalkeeper","Crystal Palace",3330,1620,1710,"Spain",37,18,19,0,0,0,0,0,0,0,0,8,6,2,59,26,33,2,0,350,341,125
"2404","Victor Nilsson Lindelöf",27,"1994","07","17","2020/2021","Defender","Manchester United",2586,1260,1326,"Sweden",29,14,15,1,1,0,1,0,1,0,0,10,5,5,27,15,12,0,0,262,227,30
"2405","Virgil van Dijk",30,"1991","07","08","2020/2021","Defender","Liverpool",371,180,191,"Netherlands",5,2,3,1,1,0,0,0,0,0,0,1,0,1,11,4,7,1,0,68,351,161
"2406","Vitor Machado Ferreira",21,"2000","02","13","2020/2021","Midfielder","Wolverhampton Wanderers",511,171,340,"Portugal",19,9,10,0,0,0,1,1,0,0,0,2,1,1,7,2,5,0,0,418,68,-1
"2407","Vladimír Coufal",29,"1992","08","22","2020/2021","Defender","West Ham United",3055,1525,1530,"Czech Republic",34,17,17,0,0,0,7,5,2,0,0,9,5,4,41,19,22,3,0,302,43,77
"2408","Vontae Daley-Campbell",20,"2001","04","02","2020/2021","Defender","Leicester City",0,0,0,"England",0,0,0,0,0,0,0,0,0,0,0,0,0,0,0,0,0,0,0,-1,-1,-1
"2409","Wayne Hennessey",34,"1987","01","24","2020/2021","Goalkeeper","Crystal Palace",0,0,0,"Wales",0,0,0,0,0,0,0,0,0,0,0,0,0,0,0,0,0,0,0,-1,-1,-1
"2410","Wes Foderingham",30,"1991","01","14","2020/2021","Goalkeeper","Sheffield United",0,0,0,"England",0,0,0,0,0,0,0,0,0,0,0,0,0,0,0,0,0,0,0,-1,-1,-1
"2411","Wes Morgan",37,"1984","01","21","2020/2021","Defender","Leicester City",15,10,5,"Jamaica",3,2,1,0,0,0,0,0,0,0,0,1,1,0,0,0,0,0,0,-1,-1,-1
"2412","Wesley Fofana",20,"2000","12","17","2020/2021","Midfielder","Leicester City",2265,1205,1060,"France",28,15,13,0,0,0,0,0,0,0,0,8,6,2,29,15,14,7,0,307,289,-1
"2413","Wesley Moraes Ferreira da Silva",24,"1996","11","26","2020/2021","Forward","Aston Villa",14,12,2,"Brazil",3,2,1,0,0,0,0,0,0,0,0,0,0,0,1,1,0,0,0,-1,-1,-1
"2414","Wilfredo Daniel Caballero",40,"1981","09","28","2020/2021","Goalkeeper","Chelsea",90,0,90,"Argentina",1,0,1,0,0,0,0,0,0,0,0,0,0,0,3,0,3,0,0,-1,-1,-1
"2415","Wilfried Zaha",28,"1992","11","10","2020/2021","Midfielder","Crystal Palace",2613,1350,1263,"Côte d'Ivoire",30,15,15,11,5,6,2,1,1,2,0,6,4,2,48,24,24,6,0,35,179,-1
"2416","Will Ferry",19,"2001","12","07","2020/2021","Midfielder","Southampton",0,0,0,"England",0,0,0,0,0,0,0,0,0,0,0,0,0,0,0,0,0,0,0,-1,-1,-1
"2417","Will Norris",28,"1993","08","12","2020/2021","Goalkeeper","Burnley",180,90,90,"England",2,1,1,0,0,0,0,0,0,0,0,0,0,0,4,3,1,0,0,-1,-1,-1
"2418","Will Osula",18,"2003","08","04","2020/2021","Forward","Sheffield United",0,0,0,"England",0,0,0,0,0,0,0,0,0,0,0,0,0,0,0,0,0,0,0,-1,-1,-1
"2419","William Fish",18,"2003","02","17","2020/2021","Midfielder","Manchester United",0,0,0,"England",1,0,1,0,0,0,0,0,0,0,0,0,0,0,0,0,0,0,0,-1,-1,-1
"2420","William Smallbone",21,"2000","02","21","2020/2021","Midfielder","Southampton",173,35,138,"England",3,1,2,0,0,0,0,0,0,0,0,0,0,0,5,3,2,0,0,-1,-1,-1
"2421","Willian",33,"1988","08","09","2020/2021","Forward","Arsenal",1406,559,847,"Brazil",25,11,14,1,1,0,5,1,4,0,0,8,2,6,17,8,9,0,0,209,11,-1
"2422","Willian José",29,"1991","11","23","2020/2021","Forward","Wolverhampton Wanderers",1114,630,484,"Brazil",17,9,8,1,1,0,0,0,0,0,0,6,3,3,13,10,3,0,0,170,269,-1
"2423","Willy Boly",30,"1991","02","03","2020/2021","Defender","Wolverhampton Wanderers",1880,1080,800,"France",21,12,9,1,1,0,1,1,0,0,0,6,3,3,27,16,11,2,0,223,207,89
"2424","Xherdan Shaqiri",30,"1991","10","10","2020/2021","Midfielder","Liverpool",552,384,168,"Switzerland",14,8,6,0,0,0,2,1,1,0,0,2,1,1,7,7,0,2,0,278,10,-1
"2425","Yann Valery",22,"1999","02","22","2020/2021","Defender","Southampton",101,98,3,"France",3,2,1,0,0,0,0,0,0,0,0,1,1,0,3,3,0,0,0,-1,-1,-1
"2426","Yerry Fernando Mina González",27,"1994","09","23","2020/2021","Defender","Everton",1939,918,1021,"Colombia",24,11,13,2,2,0,0,0,0,0,0,8,2,6,20,10,10,2,0,158,399,29
"2427","Youri Tielemans",24,"1997","05","07","2020/2021","Midfielder","Leicester City",3358,1707,1651,"Belgium",38,19,19,6,1,5,4,2,2,2,0,11,6,5,48,28,20,6,0,110,131,-1
"2428","Yves Bissouma",25,"1996","08","30","2020/2021","Midfielder","Brighton & Hove Albion",3114,1576,1538,"Mali",36,18,18,1,0,1,0,0,0,0,0,12,7,5,40,18,22,9,1,260,362,-1
"2429","Zack Steffen",26,"1995","04","02","2020/2021","Goalkeeper","Manchester City",90,0,90,"USA",1,0,1,0,0,0,0,0,0,0,0,0,0,0,0,0,0,0,0,-1,-1,-1
"2430","Zak Brunt",19,"2001","11","17","2020/2021","Midfielder","Sheffield United",0,0,0,"England",0,0,0,0,0,0,0,0,0,0,0,0,0,0,0,0,0,0,0,-1,-1,-1
"2431","Łukasz Fabiański",36,"1985","04","18","2020/2021","Goalkeeper","West Ham United",3150,1710,1440,"Poland",35,19,16,0,0,0,0,0,0,0,0,10,6,4,42,21,21,2,0,316,304,75
"2432","Aaron Anthony Connolly",21,"2000","01","28","2021/2022","Forward","Brighton & Hove Albion",58,44,14,"Republic of Ireland",2,1,1,0,0,0,0,0,0,0,0,1,1,0,0,0,0,0,0,-1,-1,-1
"2433","Aaron Cresswell",31,"1989","12","15","2021/2022","Defender","West Ham United",1141,540,601,"England",13,6,7,1,0,1,1,1,0,0,0,3,1,2,14,8,6,0,0,131,139,52
"2434","Aaron Lennon",34,"1987","04","16","2021/2022","Midfielder","Burnley",104,87,17,"England",4,2,2,0,0,0,0,0,0,0,0,1,1,0,1,1,0,1,0,-1,-1,-1
"2435","Aaron Ramsdale",23,"1998","05","14","2021/2022","Goalkeeper","Arsenal",900,540,360,"England",10,6,4,0,0,0,0,0,0,0,0,6,3,3,8,4,4,0,0,170,167,24
"2436","Aaron Ramsey",0,"1970","01","01","2021/2022","Midfielder","Aston Villa",0,0,0,"England",0,0,0,0,0,0,0,0,0,0,0,0,0,0,0,0,0,0,0,-1,-1,-1
"2437","Aaron Wan-Bissaka",23,"1997","11","26","2021/2022","Midfielder","Manchester United",1170,540,630,"England",13,6,7,0,0,0,0,0,0,0,0,2,0,2,19,11,8,2,0,233,239,-1
"2438","Abdoulaye Doucouré",28,"1993","01","01","2021/2022","Midfielder","Everton",810,360,450,"France",9,4,5,2,2,0,4,2,2,0,0,2,1,1,10,3,7,3,0,68,10,-1
"2439","Adam Armstrong",24,"1997","02","10","2021/2022","Forward","Southampton",966,336,630,"England",12,5,7,2,1,1,2,0,2,0,0,4,2,2,15,2,13,0,0,78,64,-1
"2440","Adam David Lallana",33,"1988","05","10","2021/2022","Midfielder","Brighton & Hove Albion",980,499,481,"England",12,6,6,0,0,0,1,0,1,0,0,4,2,2,12,7,5,4,0,204,122,-1
"2441","Adam Forshaw",30,"1991","10","08","2021/2022","Midfielder","Leeds United",381,180,201,"England",6,2,4,0,0,0,0,0,0,0,0,2,1,1,3,1,2,2,0,258,252,-1
"2442","Adam Masina",27,"1994","01","02","2021/2022","Defender","Watford",676,316,360,"Italy",8,4,4,0,0,0,0,0,0,0,0,0,0,0,14,5,9,0,0,264,269,110
"2443","Adam Uche Idah",20,"2001","03","11","2021/2022","Forward","Norwich City",72,39,33,"Republic of Ireland",9,5,4,0,0,0,0,0,0,0,0,2,1,1,0,0,0,0,0,-1,-1,-1
"2444","Adam Webster",26,"1995","01","04","2021/2022","Defender","Brighton & Hove Albion",502,285,217,"England",7,4,3,0,0,0,0,0,0,0,0,3,2,1,5,2,3,2,0,211,217,36
"2445","Adama Traoré Diarra",25,"1996","01","25","2021/2022","Midfielder","Wolverhampton Wanderers",681,281,400,"Spain",12,5,7,0,0,0,0,0,0,0,0,4,1,3,8,4,4,0,0,316,308,-1
"2446","Ademola Lookman",24,"1997","10","20","2021/2022","Forward","Leicester City",464,260,204,"England",8,5,3,1,1,0,0,0,0,0,0,0,0,0,10,6,4,0,0,82,192,-1
"2447","Adrián San Miguel del Castillo",34,"1987","01","03","2021/2022","Goalkeeper","Liverpool",0,0,0,"Spain",0,0,0,0,0,0,0,0,0,0,0,0,0,0,0,0,0,0,0,-1,-1,-1
"2448","Ainsley Maitland-Niles",24,"1997","08","29","2021/2022","Midfielder","Arsenal",263,192,71,"England",8,4,4,0,0,0,0,0,0,0,0,4,2,2,4,1,3,0,0,-1,-1,-1
"2449","Albert-Mboyo Sambi Lokonga",22,"1999","10","22","2021/2022","Forward","Arsenal",809,457,352,"Belgium",12,7,5,0,0,0,0,0,0,0,0,6,3,3,8,4,4,4,0,239,248,-1
"2450","Alex Iwobi",25,"1996","05","03","2021/2022","Forward","Everton",621,203,418,"Nigeria",11,5,6,1,0,1,1,1,0,0,0,2,1,1,15,4,11,0,0,97,90,-1
"2451","Alex Král",23,"1998","05","19","2021/2022","Midfielder","West Ham United",0,0,0,"Czech Republic",0,0,0,0,0,0,0,0,0,0,0,0,0,0,0,0,0,0,0,-1,-1,-1
"2452","Alex McCarthy",31,"1989","12","03","2021/2022","Goalkeeper","Southampton",1170,540,630,"England",13,6,7,0,0,0,0,0,0,0,0,5,3,2,17,4,13,1,0,295,294,71
"2453","Alex Nicolao Telles",28,"1992","12","15","2021/2022","Defender","Manchester United",107,17,90,"Brazil",2,1,1,0,0,0,0,0,0,0,0,0,0,0,1,0,1,0,0,-1,-1,-1
"2454","Alex Oxlade-Chamberlain",28,"1993","08","15","2021/2022","Midfielder","Liverpool",368,178,190,"England",8,3,5,0,0,0,1,1,0,0,0,6,2,4,4,2,2,0,0,203,41,-1
"2455","Alexandre Lacazette",30,"1991","05","28","2021/2022","Forward","Arsenal",348,174,174,"France",8,4,4,1,1,0,0,0,0,0,0,4,2,2,4,1,3,0,0,56,179,-1
"2456","Alexis Mac Allister",22,"1998","12","24","2021/2022","Midfielder","Brighton & Hove Albion",288,210,78,"Argentina",10,5,5,2,1,1,1,0,1,1,0,4,2,2,3,2,1,1,0,6,19,-1
"2457","Alisson Becker",29,"1992","10","02","2021/2022","Goalkeeper","Liverpool",1080,630,450,"Brazil",12,7,5,0,0,0,0,0,0,0,0,7,4,3,11,5,6,0,0,287,291,41
"2458","Allan",30,"1991","01","08","2021/2022","Midfielder","Everton",1144,532,612,"Brazil",13,6,7,0,0,0,1,0,1,0,0,3,2,1,18,7,11,1,0,261,141,-1
"2459","Allan Saint-Maximin",24,"1997","03","12","2021/2022","Midfielder","Newcastle United",1238,617,621,"France",14,7,7,3,3,0,3,1,2,0,0,0,0,0,27,15,12,2,0,69,51,-1
"2460","Alphonse Areola",28,"1993","02","27","2021/2022","Goalkeeper","West Ham United",0,0,0,"France",0,0,0,0,0,0,0,0,0,0,0,0,0,0,0,0,0,0,0,-1,-1,-1
"2461","Álvaro Fernández Llorente",23,"1998","04","13","2021/2022","Goalkeeper","Brentford",360,180,180,"Spain",4,2,2,0,0,0,0,0,0,0,0,1,1,0,8,2,6,0,0,192,184,119
"2462","Andi Zeqiri",22,"1999","06","22","2021/2022","Forward","Brighton & Hove Albion",0,0,0,"Switzerland",0,0,0,0,0,0,0,0,0,0,0,0,0,0,0,0,0,0,0,-1,-1,-1
"2463","André Filipe Tavares Gomes",28,"1993","07","30","2021/2022","Midfielder","Everton",65,29,36,"Portugal",3,1,2,0,0,0,0,0,0,0,0,1,0,1,3,0,3,0,0,-1,-1,-1
"2464","Andreas Christensen",25,"1996","04","10","2021/2022","Defender","Chelsea",720,270,450,"Denmark",8,3,5,0,0,0,0,0,0,0,0,5,1,4,3,2,1,1,0,220,211,7
"2465","Andreas Pereira",25,"1996","01","01","2021/2022","Midfielder","Manchester United",0,0,0,"Brazil",0,0,0,0,0,0,0,0,0,0,0,0,0,0,0,0,0,0,0,-1,-1,-1
"2466","Andrew Lonergan",38,"1983","10","19","2021/2022","Goalkeeper","Everton",0,0,0,"England",0,0,0,0,0,0,0,0,0,0,0,0,0,0,0,0,0,0,0,-1,-1,-1
"2467","Andrew Omobamidele",19,"2002","06","23","2021/2022","Defender","Norwich City",291,90,201,"England",4,1,3,1,1,0,0,0,0,0,0,0,0,0,5,2,3,1,0,46,180,89
"2468","Andrew Robertson",27,"1994","03","11","2021/2022","Defender","Liverpool",780,356,424,"Scotland",9,4,5,0,0,0,2,1,1,0,0,4,1,3,11,5,6,2,0,198,47,64
"2469","Andriy Yarmolenko",32,"1989","10","23","2021/2022","Forward","West Ham United",52,26,26,"Ukraine",8,3,5,0,0,0,0,0,0,0,0,2,0,2,1,1,0,0,0,-1,-1,-1
"2470","Andros Townsend",30,"1991","07","16","2021/2022","Midfielder","Everton",1041,506,535,"England",13,6,7,3,2,1,2,2,0,1,0,3,2,1,17,7,10,2,0,57,74,-1
"2471","Angelo Ogbonna",33,"1988","05","23","2021/2022","Defender","West Ham United",922,472,450,"Italy",11,6,5,1,0,1,0,0,0,0,0,3,1,2,10,6,4,1,0,123,168,43
"2472","Angus Gunn",25,"1996","01","22","2021/2022","Goalkeeper","Norwich City",0,0,0,"England",0,0,0,0,0,0,0,0,0,0,0,0,0,0,0,0,0,0,0,-1,-1,-1
"2473","Anthony Gordon",20,"2001","02","24","2021/2022","Midfielder","Everton",458,176,282,"England",10,5,5,0,0,0,0,0,0,0,0,2,2,0,7,1,6,1,0,294,265,-1
"2474","Anthony Martial",25,"1995","12","05","2021/2022","Forward","Manchester United",198,77,121,"France",6,3,3,1,1,0,0,0,0,0,0,1,0,1,1,0,1,0,0,-1,-1,-1
"2475","Antonio Rüdiger",28,"1993","03","03","2021/2022","Defender","Chelsea",1080,630,450,"Germany",12,7,5,2,0,2,0,0,0,0,0,7,3,4,5,4,1,2,0,90,222,10
"2476","Anwar El Ghazi",26,"1995","05","03","2021/2022","Forward","Aston Villa",369,204,165,"Netherlands",8,4,4,1,1,0,1,0,1,1,0,2,2,0,6,3,3,2,0,62,43,-1
"2477","Armando Broja",20,"2001","09","10","2021/2022","Forward","Southampton",375,211,164,"England",9,5,4,2,2,0,0,0,0,0,0,4,3,1,7,2,5,0,0,18,177,-1
"2478","Arthur Masuaku",28,"1993","11","07","2021/2022","Defender","West Ham United",78,4,74,"France",2,1,1,0,0,0,0,0,0,0,0,0,0,0,1,0,1,0,0,-1,-1,-1
"2479","Arthur Okonkwo",20,"2001","09","09","2021/2022","Goalkeeper","Arsenal",0,0,0,"England",0,0,0,0,0,0,0,0,0,0,0,0,0,0,0,0,0,0,0,-1,-1,-1
"2480","Ashley Barnes",32,"1989","10","30","2021/2022","Forward","Burnley",381,166,215,"England",8,4,4,0,0,0,0,0,0,0,0,1,1,0,10,3,7,2,0,208,214,-1
"2481","Ashley Fletcher",26,"1995","10","02","2021/2022","Forward","Watford",27,8,19,"England",3,1,2,0,0,0,0,0,0,0,0,0,0,0,0,0,0,0,0,-1,-1,-1
"2482","Ashley Westwood",31,"1990","04","01","2021/2022","Midfielder","Burnley",990,540,450,"England",11,6,5,0,0,0,3,2,1,0,0,1,1,0,18,8,10,5,0,206,27,-1
"2483","Ashley Young",36,"1985","07","09","2021/2022","Midfielder","Aston Villa",454,279,175,"England",8,6,2,0,0,0,2,1,1,0,0,3,3,0,9,6,3,0,0,272,13,-1
"2484","Asmir Begović",34,"1987","06","20","2021/2022","Goalkeeper","Everton",90,0,90,"Bosnia and Herzegovina",1,0,1,0,0,0,0,0,0,0,0,0,0,0,3,0,3,0,0,-1,-1,-1
"2485","Axel Tuanzebe",23,"1997","11","14","2021/2022","Defender","Aston Villa",498,272,226,"England",7,4,3,0,0,0,0,0,0,0,0,2,2,0,8,3,5,1,0,275,281,80
"2486","Aymeric Laporte",27,"1994","05","27","2021/2022","Defender","Manchester City",823,463,360,"France",10,6,4,1,1,0,0,0,0,0,0,6,4,2,4,1,3,6,1,112,169,14
"2487","Ayoze Perez",28,"1993","07","29","2021/2022","Forward","Leicester City",131,79,52,"Spain",4,2,2,0,0,0,2,2,0,0,0,1,1,0,2,1,1,1,1,-1,-1,-1
"2488","Bakayo Sako",0,"1970","01","01","2021/2022","Midfielder","Arsenal",960,528,432,"England",13,7,6,2,2,0,2,1,1,0,0,6,3,3,12,4,8,1,0,80,61,-1
"2489","Bali Mumba",0,"1970","01","01","2021/2022","Defender","Norwich City",44,0,44,"England",1,0,1,0,0,0,0,0,0,0,0,0,0,0,3,0,3,0,0,-1,-1,-1
"2490","Ben Chilwell",24,"1996","12","21","2021/2022","Defender","Chelsea",540,270,270,"England",6,3,3,3,2,1,1,0,1,0,0,4,1,3,2,2,0,0,0,15,70,6
"2491","Ben Davies",28,"1993","04","24","2021/2022","Defender","Tottenham Hotspur",300,180,120,"Wales",4,2,2,0,0,0,0,0,0,0,0,1,0,1,6,4,2,1,0,182,204,104
"2492","Ben Foster",38,"1983","04","03","2021/2022","Goalkeeper","Watford",720,360,360,"England",8,4,4,0,0,0,1,1,0,0,0,0,0,0,12,7,5,0,0,270,95,84
"2493","Ben Gibson",28,"1993","01","15","2021/2022","Defender","Norwich City",965,450,515,"England",11,5,6,0,0,0,0,0,0,0,0,3,2,1,20,6,14,3,1,276,284,112
"2494","Ben Godfrey",23,"1998","01","15","2021/2022","Midfielder","Everton",861,421,440,"England",10,5,5,0,0,0,0,0,0,0,0,2,2,0,16,6,10,2,0,175,160,-1
"2495","Ben Mee",32,"1989","09","21","2021/2022","Defender","Burnley",810,450,360,"England",9,5,4,2,1,1,0,0,0,0,0,0,0,0,16,8,8,1,0,67,236,103
"2496","Ben White",24,"1997","10","08","2021/2022","Defender","Arsenal",990,540,450,"England",11,6,5,0,0,0,0,0,0,0,0,6,3,3,10,4,6,1,0,237,246,37
"2497","Benjamin Johnson",21,"2000","01","24","2021/2022","Forward","West Ham United",540,180,360,"England",7,2,5,1,0,1,0,0,0,0,0,2,1,1,5,2,3,0,0,89,195,-1
"2498","Benjamin Mendy",27,"1994","07","17","2021/2022","Defender","Manchester City",79,0,79,"France",1,0,1,0,0,0,0,0,0,0,0,0,0,0,1,0,1,0,0,-1,-1,-1
"2499","Benjamin Woodburn",22,"1999","10","15","2021/2022","Forward","Liverpool",0,0,0,"Wales",0,0,0,0,0,0,0,0,0,0,0,0,0,0,0,0,0,0,0,-1,-1,-1
"2500","Bernardo Silva",27,"1994","08","10","2021/2022","Midfielder","Manchester City",1030,580,450,"Portugal",12,7,5,4,2,2,1,0,1,0,0,8,5,3,5,2,3,3,0,35,126,-1
"2501","Bernd Leno",29,"1992","03","04","2021/2022","Goalkeeper","Arsenal",270,90,180,"Germany",3,1,2,0,0,0,0,0,0,0,0,0,0,0,9,2,7,0,0,-1,-1,-1
"2502","Bertrand Traoré",26,"1995","09","06","2021/2022","Forward","Aston Villa",53,4,49,"Burkina Faso",4,1,3,0,0,0,0,0,0,0,0,1,1,0,0,0,0,0,0,-1,-1,-1
"2503","Billy Gilmour",20,"2001","06","11","2021/2022","Midfielder","Norwich City",615,435,180,"Scotland",7,5,2,0,0,0,1,1,0,0,0,1,1,0,15,9,6,1,0,284,84,-1
"2504","Bobby Thomas",0,"1970","01","01","2021/2022","Defender","Burnley",0,0,0,"England",0,0,0,0,0,0,0,0,0,0,0,0,0,0,0,0,0,0,0,-1,-1,-1
"2505","Boubakary Soumaré",22,"1999","02","27","2021/2022","Midfielder","Leicester City",729,435,294,"France",11,6,5,0,0,0,1,0,1,0,0,1,1,0,18,11,7,0,0,312,97,-1
"2506","Brandon Williams",21,"2000","09","03","2021/2022","Defender","Norwich City",743,360,383,"England",9,4,5,0,0,0,0,0,0,0,0,1,1,0,14,6,8,3,0,250,256,99
"2507","Bruno Miguel Borges Fernandes",27,"1994","09","08","2021/2022","Midfielder","Manchester United",1122,507,615,"Portugal",13,6,7,4,4,0,3,1,2,0,1,2,0,2,19,11,8,4,0,42,40,-1
"2508","Bryan Gil Salvatierra",20,"2001","02","11","2021/2022","Forward","Tottenham Hotspur",57,31,26,"Spain",5,3,2,0,0,0,0,0,0,0,0,1,1,0,0,0,0,0,0,-1,-1,-1
"2509","Bryan Mbeumo",22,"1999","08","07","2021/2022","Forward","Brentford",1012,593,419,"France",12,7,5,2,0,2,0,0,0,0,0,4,2,2,12,7,5,2,0,83,244,-1
"2510","Caglar Söyüncü",25,"1996","05","23","2021/2022","Defender","Leicester City",1148,630,518,"Turkey",13,7,6,1,1,0,0,0,0,0,0,1,1,0,23,12,11,2,0,144,309,105
"2511","Callum Hudson-Odoi",21,"2000","11","07","2021/2022","Midfielder","Chelsea",558,380,178,"England",7,5,2,1,1,0,0,0,0,0,0,4,2,2,3,3,0,0,0,93,226,-1
"2512","Callum Wilson",29,"1992","02","27","2021/2022","Forward","Newcastle United",861,501,360,"England",10,6,4,5,4,1,0,0,0,1,0,0,0,0,20,14,6,4,0,12,162,-1
"2513","Calum Chambers",26,"1995","01","20","2021/2022","Defender","Arsenal",171,0,171,"England",2,0,2,0,0,0,0,0,0,0,0,0,0,0,7,0,7,0,0,-1,-1,-1
"2514","Cameron Archer",0,"1970","01","01","2021/2022","Forward","Aston Villa",24,0,24,"England",3,0,3,0,0,0,0,0,0,0,0,1,0,1,0,0,0,0,0,-1,-1,-1
"2515","Caoimhin Kelleher",22,"1998","11","23","2021/2022","Goalkeeper","Liverpool",90,0,90,"Republic of Ireland",1,0,1,0,0,0,0,0,0,0,0,1,0,1,0,0,0,0,0,-1,-1,-1
"2516","Carney Chukwuemeka",0,"1970","01","01","2021/2022","Midfielder","Aston Villa",63,63,0,"England",1,1,0,0,0,0,0,0,0,0,0,0,0,0,1,1,0,0,0,-1,-1,-1
"2517","Cedric Soares",30,"1991","08","31","2021/2022","Defender","Arsenal",188,98,90,"Portugal",3,2,1,0,0,0,0,0,0,0,0,1,1,0,7,2,5,1,0,-1,-1,-1
"2518","Cenk Tosun",30,"1991","06","07","2021/2022","Forward","Everton",0,0,0,"Turkey",0,0,0,0,0,0,0,0,0,0,0,0,0,0,0,0,0,0,0,-1,-1,-1
"2519","Cesar Azpilicueta",32,"1989","08","28","2021/2022","Defender","Chelsea",632,273,359,"Spain",8,4,4,0,0,0,2,2,0,0,0,5,2,3,3,2,1,0,0,219,23,11
"2520","Charlie Cresswell",18,"2002","12","07","2021/2022","Defender","Leeds United",90,90,0,"England",2,2,0,0,0,0,0,0,0,0,0,0,0,0,1,1,0,0,0,-1,-1,-1
"2521","Charlie Goode",26,"1995","08","03","2021/2022","Defender","Brentford",178,168,10,"England",3,2,1,0,0,0,0,0,0,0,0,1,1,0,1,1,0,1,0,-1,-1,-1
"2522","Charlie Taylor",28,"1993","09","18","2021/2022","Defender","Burnley",990,540,450,"England",11,6,5,0,0,0,1,1,0,0,0,1,1,0,18,8,10,0,0,217,127,93
"2523","Charlie Whitaker",0,"1970","01","01","2021/2022","Midfielder","Everton",0,0,0,"England",0,0,0,0,0,0,0,0,0,0,0,0,0,0,0,0,0,0,0,-1,-1,-1
"2524","Che Adams",25,"1996","07","13","2021/2022","Midfielder","Southampton",682,255,427,"England",10,4,6,2,0,2,1,0,1,0,0,3,1,2,10,2,8,0,0,59,94,-1
"2525","Cheikhou Kouyaté",31,"1989","12","21","2021/2022","Midfielder","Crystal Palace",904,355,549,"Senegal",12,5,7,0,0,0,1,1,0,0,0,4,3,1,12,2,10,0,0,225,116,-1
"2526","Chem Campbell",18,"2002","12","30","2021/2022","Midfielder","Wolverhampton Wanderers",0,0,0,"England",0,0,0,0,0,0,0,0,0,0,0,0,0,0,0,0,0,0,0,-1,-1,-1
"2527","Chris Wood",29,"1991","12","07","2021/2022","Forward","Burnley",995,511,484,"New Zealand",12,6,6,3,3,0,0,0,0,0,0,1,1,0,20,8,12,1,0,54,213,-1
"2528","Christian Benteke",30,"1990","12","03","2021/2022","Forward","Crystal Palace",881,466,415,"Belgium",14,7,7,4,1,3,1,0,1,0,0,4,3,1,11,3,8,3,0,28,115,-1
"2529","Christian Kabasele",30,"1991","02","24","2021/2022","Defender","Watford",202,90,112,"Belgium",3,1,2,0,0,0,0,0,0,0,0,0,0,0,3,1,2,0,0,-1,-1,-1
"2530","Christian Marques",18,"2003","01","15","2021/2022","Defender","Wolverhampton Wanderers",0,0,0,"Portugal",0,0,0,0,0,0,0,0,0,0,0,0,0,0,0,0,0,0,0,-1,-1,-1
"2531","Christian Nørgaard",27,"1994","03","10","2021/2022","Midfielder","Brentford",1138,598,540,"Denmark",13,7,6,1,1,0,1,0,1,0,0,4,2,2,16,8,8,4,0,136,143,-1
"2532","Christian Pulisic",23,"1998","09","18","2021/2022","Midfielder","Chelsea",127,99,28,"USA",4,3,1,2,1,1,0,0,0,0,0,2,1,1,0,0,0,0,0,-1,-1,-1
"2533","Christoph Zimmermann",28,"1993","01","12","2021/2022","Defender","Norwich City",0,0,0,"Germany",0,0,0,0,0,0,0,0,0,0,0,0,0,0,0,0,0,0,0,-1,-1,-1
"2534","Christos Tzolis",19,"2002","01","30","2021/2022","Forward","Norwich City",198,63,135,"Greece",7,4,3,0,0,0,0,0,0,0,0,1,1,0,3,1,2,0,0,-1,-1,-1
"2535","Ciaran Clark",32,"1989","09","26","2021/2022","Defender","Newcastle United",903,459,444,"Republic of Ireland",11,6,5,0,0,0,1,0,1,0,0,0,0,0,22,14,8,3,1,158,113,124
"2536","Cieran Slicker",0,"1970","01","01","2021/2022","Goalkeeper","Manchester City",0,0,0,"England",0,0,0,0,0,0,0,0,0,0,0,0,0,0,0,0,0,0,0,-1,-1,-1
"2537","Cody Drameh",0,"1970","01","01","2021/2022","Midfielder","Leeds United",19,0,19,"England",1,0,1,0,0,0,0,0,0,0,0,0,0,0,0,0,0,1,0,-1,-1,-1
"2538","Cole Palmer",19,"2002","05","06","2021/2022","Defender","Manchester City",108,108,0,"England",3,3,0,0,0,0,0,0,0,0,0,3,3,0,0,0,0,0,0,-1,-1,-1
"2539","Connor Roberts",26,"1995","09","23","2021/2022","Midfielder","Burnley",0,0,0,"Wales",0,0,0,0,0,0,0,0,0,0,0,0,0,0,0,0,0,0,0,-1,-1,-1
"2540","Conor Bradley",18,"2003","07","09","2021/2022","Midfielder","Liverpool",0,0,0,"Northern Ireland",0,0,0,0,0,0,0,0,0,0,0,0,0,0,0,0,0,0,0,-1,-1,-1
"2541","Conor Coady",28,"1993","02","25","2021/2022","Midfielder","Wolverhampton Wanderers",1167,537,630,"England",13,6,7,1,0,1,0,0,0,0,0,4,1,3,11,6,5,2,0,133,315,-1
"2542","Conor Coventry",21,"2000","03","25","2021/2022","Midfielder","West Ham United",0,0,0,"Republic of Ireland",0,0,0,0,0,0,0,0,0,0,0,0,0,0,0,0,0,0,0,-1,-1,-1
"2543","Conor Gallagher",21,"2000","02","06","2021/2022","Midfielder","Crystal Palace",1138,607,531,"England",13,7,6,4,1,3,3,1,2,0,0,4,3,1,14,5,9,4,0,43,36,-1
"2544","Conor Hourihane",30,"1991","02","02","2021/2022","Midfielder","Aston Villa",0,0,0,"Republic of Ireland",0,0,0,0,0,0,0,0,0,0,0,0,0,0,0,0,0,0,0,-1,-1,-1
"2545","Craig Cathcart",32,"1989","02","06","2021/2022","Defender","Watford",926,450,476,"Northern Ireland",11,5,6,0,0,0,1,0,1,0,0,0,0,0,19,8,11,2,0,277,109,108
"2546","Craig Dawson",31,"1990","05","06","2021/2022","Defender","West Ham United",619,248,371,"England",10,4,6,0,0,0,0,0,0,0,0,3,1,2,9,5,4,0,0,160,189,70
"2547","Cristian Gabriel Romero",23,"1998","04","27","2021/2022","Defender","Tottenham Hotspur",533,263,270,"Argentina",7,4,3,0,0,0,0,0,0,0,0,2,1,1,9,6,3,4,0,190,203,86
"2548","Cristiano Ronaldo",36,"1985","02","05","2021/2022","Forward","Manchester United",760,393,367,"Portugal",10,5,5,4,2,2,2,0,2,0,0,1,0,1,17,10,7,3,0,19,42,-1
"2549","Crysencio Summerville",20,"2001","10","30","2021/2022","Forward","Leeds United",68,36,32,"Netherlands",4,2,2,0,0,0,0,0,0,0,0,0,0,0,0,0,0,0,0,-1,-1,-1
"2550","Curtis Jones",20,"2001","01","30","2021/2022","Midfielder","Liverpool",322,191,131,"England",5,3,2,1,0,1,1,1,0,0,0,2,1,1,6,4,2,0,0,48,24,-1
"2551","Damián Emiliano Martínez",29,"1992","09","02","2021/2022","Goalkeeper","Aston Villa",1080,540,540,"Argentina",12,6,6,0,0,0,0,0,0,0,0,4,3,1,16,7,9,1,0,271,276,73
"2552","Dan Burn",29,"1992","05","09","2021/2022","Defender","Brighton & Hove Albion",303,167,136,"England",5,3,2,0,0,0,0,0,0,0,0,2,1,1,4,3,1,1,0,178,166,56
"2553","Dan Gosling",31,"1990","02","01","2021/2022","Midfielder","Watford",21,21,0,"England",1,1,0,0,0,0,0,0,0,0,0,0,0,0,1,1,0,0,0,-1,-1,-1
"2554","Dane Scarlett",0,"1970","01","01","2021/2022","Forward","Tottenham Hotspur",0,0,0,"England",0,0,0,0,0,0,0,0,0,0,0,0,0,0,0,0,0,0,0,-1,-1,-1
"2555","Daniel Amartey",26,"1994","12","21","2021/2022","Midfielder","Leicester City",606,316,290,"Ghana",8,4,4,0,0,0,0,0,0,0,0,1,1,0,13,7,6,1,0,308,307,-1
"2556","Daniel Bachmann",27,"1994","07","09","2021/2022","Goalkeeper","Watford",450,180,270,"Austria",5,2,3,0,0,0,0,0,0,0,0,0,0,0,10,3,7,0,0,291,292,121
"2557","Daniel Castelo Podence",26,"1995","10","21","2021/2022","Forward","Wolverhampton Wanderers",257,125,132,"Portugal",9,4,5,0,0,0,2,1,1,0,0,3,1,2,2,1,1,0,0,-1,-1,-1
"2558","Daniel James",24,"1997","11","10","2021/2022","Midfielder","Leeds United",964,503,461,"Wales",13,7,6,1,0,1,1,0,1,0,0,4,2,2,8,3,5,0,0,127,124,-1
"2559","Daniel William John Ings",29,"1992","07","23","2021/2022","Forward","Aston Villa",829,426,403,"England",10,5,5,3,2,1,2,2,0,1,0,4,3,1,13,3,10,1,0,39,54,-1
"2560","Danny Rose",31,"1990","07","02","2021/2022","Defender","Watford",540,270,270,"England",6,3,3,0,0,0,0,0,0,0,0,0,0,0,10,7,3,2,0,269,275,97
"2561","Danny Ward",28,"1993","06","22","2021/2022","Goalkeeper","Leicester City",0,0,0,"Wales",0,0,0,0,0,0,0,0,0,0,0,0,0,0,0,0,0,0,0,-1,-1,-1
"2562","Danny Welbeck",30,"1990","11","26","2021/2022","Forward","Brighton & Hove Albion",241,101,140,"England",4,2,2,1,1,0,0,0,0,0,0,1,0,1,2,1,1,0,0,-1,-1,-1
"2563","David de Gea",31,"1990","11","07","2021/2022","Goalkeeper","Manchester United",1170,540,630,"Spain",13,6,7,0,0,0,0,0,0,0,0,2,0,2,19,11,8,0,0,242,249,82
"2564","David Raya Martin",26,"1995","09","15","2021/2022","Goalkeeper","Brentford",810,450,360,"Spain",9,5,4,0,0,0,0,0,0,0,0,3,1,2,8,6,2,0,0,159,209,35
"2565","Davinson Sánchez Mina",25,"1996","06","12","2021/2022","Defender","Tottenham Hotspur",389,209,180,"Colombia",6,4,2,0,0,0,0,0,0,0,0,3,2,1,3,0,3,1,0,184,190,22
"2566","Dean Henderson",24,"1997","03","12","2021/2022","Goalkeeper","Manchester United",0,0,0,"England",0,0,0,0,0,0,0,0,0,0,0,0,0,0,0,0,0,0,0,-1,-1,-1
"2567","Declan Rice",22,"1999","01","14","2021/2022","Midfielder","West Ham United",1170,540,630,"Republic of Ireland",13,6,7,1,0,1,3,1,2,0,0,3,1,2,14,8,6,4,0,137,49,-1
"2568","Dele Alli",25,"1996","04","11","2021/2022","Midfielder","Tottenham Hotspur",515,289,226,"England",8,5,3,1,0,1,0,0,0,1,0,3,2,1,8,3,5,1,0,91,200,-1
"2569","Demarai Gray",25,"1996","06","28","2021/2022","Midfielder","Everton",982,511,471,"England",13,6,7,3,1,2,2,2,0,0,0,3,2,1,12,4,8,0,0,53,67,-1
"2570","Dennis Praet",27,"1994","05","14","2021/2022","Midfielder","Leicester City",0,0,0,"Belgium",0,0,0,0,0,0,0,0,0,0,0,0,0,0,0,0,0,0,0,-1,-1,-1
"2571","Diego Llorente",28,"1993","08","16","2021/2022","Defender","Leeds United",818,393,425,"Spain",10,5,5,1,1,0,0,0,0,0,0,3,2,1,8,3,5,3,0,117,170,34
"2572","Dilan Kumar Markanday",20,"2001","08","20","2021/2022","Midfielder","Tottenham Hotspur",0,0,0,"England",0,0,0,0,0,0,0,0,0,0,0,0,0,0,0,0,0,0,0,-1,-1,-1
"2573","Dimitris Giannoulis",26,"1995","10","17","2021/2022","Midfielder","Norwich City",399,180,219,"Greece",8,2,6,0,0,0,1,0,1,0,0,2,1,1,8,3,5,1,0,278,44,-1
"2574","Diogo José Teixeira da Silva",24,"1996","12","04","2021/2022","Midfielder","Liverpool",840,441,399,"Portugal",12,7,5,7,4,3,1,0,1,0,0,7,4,3,6,0,6,1,0,4,103,-1
"2575","Divock Origi",26,"1995","04","18","2021/2022","Forward","Liverpool",16,2,14,"Belgium",2,1,1,1,0,1,0,0,0,0,0,1,1,0,0,0,0,0,0,-1,-1,-1
"2576","Dominic Calvert-Lewin",24,"1997","03","16","2021/2022","Forward","Everton",249,90,159,"England",3,1,2,3,1,2,0,0,0,2,0,1,0,1,3,1,2,0,0,-1,-1,-1
"2577","Dominic Thompson",21,"2000","07","26","2021/2022","Defender","Brentford",0,0,0,"England",0,0,0,0,0,0,0,0,0,0,0,0,0,0,0,0,0,0,0,-1,-1,-1
"2578","Donny van de Beek",24,"1997","04","18","2021/2022","Midfielder","Manchester United",60,15,45,"Netherlands",4,2,2,1,0,1,0,0,0,0,0,0,0,0,0,0,0,0,0,-1,-1,-1
"2579","Douglas Luiz",23,"1998","05","09","2021/2022","Midfielder","Aston Villa",707,335,372,"Brazil",9,4,5,0,0,0,2,1,1,0,0,3,2,1,8,1,7,3,0,199,32,-1
"2580","Dwight Gayle",31,"1990","10","17","2021/2022","Forward","Newcastle United",20,0,20,"England",3,0,3,0,0,0,0,0,0,0,0,0,0,0,0,0,0,0,0,-1,-1,-1
"2581","Dwight McNeil",21,"1999","11","22","2021/2022","Forward","Burnley",1066,529,537,"England",12,6,6,0,0,0,1,1,0,0,0,1,1,0,20,8,12,1,0,207,144,-1
"2582","Eberechi Eze",23,"1998","06","29","2021/2022","Midfielder","Crystal Palace",30,30,0,"Nigeria",1,1,0,0,0,0,0,0,0,0,0,0,0,0,1,1,0,0,0,-1,-1,-1
"2583","Ederson",28,"1993","08","17","2021/2022","Goalkeeper","Manchester City",1080,540,540,"Brazil",12,6,6,0,0,0,0,0,0,0,0,7,4,3,6,2,4,2,0,193,207,17
"2584","Edinson Cavani",34,"1987","02","14","2021/2022","Forward","Manchester United",213,94,119,"Uruguay",5,3,2,1,0,1,0,0,0,0,0,2,0,2,1,1,0,0,0,-1,-1,-1
"2585","Edouard Mendy",29,"1992","03","01","2021/2022","Goalkeeper","Chelsea",1080,630,450,"France",12,7,5,0,0,0,0,0,0,0,0,7,3,4,5,4,1,2,0,218,221,9
"2586","Edward Nketiah",22,"1999","05","30","2021/2022","Forward","Arsenal",0,0,0,"England",0,0,0,0,0,0,0,0,0,0,0,0,0,0,0,0,0,0,0,-1,-1,-1
"2587","Eldin Jakupovic",37,"1984","10","02","2021/2022","Goalkeeper","Leicester City",0,0,0,"Switzerland",0,0,0,0,0,0,0,0,0,0,0,0,0,0,0,0,0,0,0,-1,-1,-1
"2588","Elliott Anderson",0,"1970","01","01","2021/2022","Midfielder","Newcastle United",0,0,0,"England",0,0,0,0,0,0,0,0,0,0,0,0,0,0,0,0,0,0,0,-1,-1,-1
"2589","Ellis Simms",20,"2001","01","05","2021/2022","Midfielder","Everton",0,0,0,"England",0,0,0,0,0,0,0,0,0,0,0,0,0,0,0,0,0,0,0,-1,-1,-1
"2590","Emerson Aparecido Leite de Souza Junior",22,"1999","01","14","2021/2022","Defender","Tottenham Hotspur",764,360,404,"Brazil",9,4,5,0,0,0,0,0,0,0,0,1,0,1,12,7,5,2,0,167,199,77
"2591","Emerson Palmieri dos Santos",27,"1994","08","03","2021/2022","Defender","Chelsea",4,4,0,"Italy",1,1,0,0,0,0,0,0,0,0,0,1,1,0,0,0,0,0,0,-1,-1,-1
"2592","Emil Krafth",27,"1994","08","02","2021/2022","Defender","Newcastle United",453,183,270,"Sweden",6,3,3,0,0,0,1,0,1,0,0,0,0,0,11,7,4,1,0,153,59,125
"2593","Emile Smith Rowe",21,"2000","07","28","2021/2022","Midfielder","Arsenal",1073,562,511,"England",13,7,6,4,3,1,2,2,0,0,0,6,3,3,17,6,11,0,0,36,78,-1
"2594","Emiliano Buendía",24,"1996","12","25","2021/2022","Midfielder","Aston Villa",625,376,249,"Argentina",11,5,6,1,1,0,1,1,0,0,0,3,2,1,11,3,8,1,0,95,89,-1
"2595","Emmanuel Bonaventure Dennis",23,"1997","11","15","2021/2022","Forward","Watford",904,390,514,"Nigeria",12,5,7,5,2,3,5,3,2,0,0,0,0,0,18,8,10,6,0,14,8,-1
"2596","Enock Mwepu",23,"1998","01","01","2021/2022","Midfielder","Brighton & Hove Albion",260,124,136,"Zambia",6,4,2,1,0,1,0,0,0,0,0,1,1,0,3,0,3,1,0,-1,-1,-1
"2597","Eric Bertrand Bailly",27,"1994","04","12","2021/2022","Defender","Manchester United",136,46,90,"Côte d'Ivoire",2,1,1,0,0,0,0,0,0,0,0,0,0,0,3,2,1,1,0,-1,-1,-1
"2598","Eric Dier",27,"1994","01","15","2021/2022","Midfielder","Tottenham Hotspur",1002,540,462,"England",12,6,6,0,0,0,0,0,0,0,0,4,2,2,13,7,6,0,0,187,201,-1
"2599","Erik Pieters",33,"1988","08","07","2021/2022","Defender","Burnley",103,0,103,"Netherlands",3,0,3,0,0,0,0,0,0,0,0,0,0,0,2,0,2,0,0,-1,-1,-1
"2600","Ethan Pinnock",28,"1993","05","29","2021/2022","Defender","Brentford",1079,539,540,"England",13,7,6,1,1,0,1,1,0,0,0,4,2,2,13,5,8,0,0,146,140,51
"2601","Ezri Konsa Ngoyo",23,"1998","04","06","2021/2022","Midfielder","Aston Villa",1039,499,540,"England",12,6,6,0,0,0,0,0,0,0,0,4,3,1,15,5,10,2,1,273,277,-1
"2602","Fabian Delph",31,"1989","11","21","2021/2022","Midfielder","Everton",174,60,114,"England",4,1,3,0,0,0,0,0,0,0,0,1,1,0,2,0,2,1,0,-1,-1,-1
"2603","Fabian Schär",29,"1991","12","20","2021/2022","Defender","Newcastle United",431,251,180,"Switzerland",5,3,2,0,0,0,0,0,0,0,0,0,0,0,9,5,4,2,0,157,154,114
"2604","Fabinho",28,"1993","10","23","2021/2022","Midfielder","Liverpool",739,450,289,"Brazil",9,5,4,1,0,1,1,0,1,0,0,5,3,2,9,3,6,3,0,110,99,-1
"2605","Fábio Daniel Soares Silva",19,"2002","07","19","2021/2022","Forward","Wolverhampton Wanderers",34,17,17,"Portugal",7,4,3,0,0,0,0,0,0,0,0,0,0,0,0,0,0,0,0,-1,-1,-1
"2606","Federico Fernández",32,"1989","02","21","2021/2022","Defender","Newcastle United",517,259,258,"Argentina",6,3,3,0,0,0,0,0,0,0,0,0,0,0,11,6,5,0,0,151,149,116
"2607","Fernando Luiz Rosa",36,"1985","05","04","2021/2022","Midfielder","Manchester City",188,74,114,"Brazil",7,3,4,1,1,0,0,0,0,0,0,4,2,2,2,0,2,0,0,-1,-1,-1
"2608","Fernando Marçal",32,"1989","02","19","2021/2022","Defender","Wolverhampton Wanderers",686,342,344,"Brazil",8,4,4,0,0,0,0,0,0,0,0,2,0,2,8,5,3,2,0,314,314,49
"2609","Ferrán Torres García",21,"2000","02","29","2021/2022","Forward","Manchester City",305,151,154,"Spain",4,2,2,2,2,0,1,1,0,0,0,3,2,1,1,0,1,0,0,7,20,-1
"2610","Finley Stevens",0,"1970","01","01","2021/2022","Midfielder","Brentford",0,0,0,"England",0,0,0,0,0,0,0,0,0,0,0,0,0,0,0,0,0,0,0,-1,-1,-1
"2611","Florin Andone",28,"1993","04","11","2021/2022","Forward","Brighton & Hove Albion",0,0,0,"Romania",0,0,0,0,0,0,0,0,0,0,0,0,0,0,0,0,0,0,0,-1,-1,-1
"2612","Folarin Balogun",20,"2001","07","03","2021/2022","Midfielder","Arsenal",70,11,59,"England",2,1,1,0,0,0,0,0,0,0,0,0,0,0,1,0,1,0,0,-1,-1,-1
"2613","Francisco António Machado Mota de Castro Trincão",21,"1999","12","29","2021/2022","Forward","Wolverhampton Wanderers",694,409,285,"Portugal",9,5,4,0,0,0,0,0,0,0,0,2,0,2,7,5,2,0,0,317,293,-1
"2614","Francisco Femenía Far",30,"1991","02","02","2021/2022","Midfielder","Watford",542,213,329,"Spain",7,3,4,0,0,0,2,1,1,0,0,0,0,0,13,6,7,1,0,177,18,-1
"2615","Francisco Sierralta Carvallo",24,"1997","05","06","2021/2022","Forward","Watford",248,90,158,"Chile",3,1,2,0,0,0,0,0,0,0,0,0,0,0,4,2,2,0,0,-1,-1,-1
"2616","Fraser Forster",33,"1988","03","17","2021/2022","Goalkeeper","Southampton",0,0,0,"England",0,0,0,0,0,0,0,0,0,0,0,0,0,0,0,0,0,0,0,-1,-1,-1
"2617","Freddie Woodman",24,"1997","03","04","2021/2022","Goalkeeper","Newcastle United",360,180,180,"England",4,2,2,0,0,0,0,0,0,0,0,0,0,0,10,5,5,0,0,150,164,127
"2618","Frédéric Guilbert",26,"1994","12","24","2021/2022","Defender","Aston Villa",0,0,0,"France",0,0,0,0,0,0,0,0,0,0,0,0,0,0,0,0,0,0,0,-1,-1,-1
"2619","Frederico Rodrigues Santos",28,"1993","03","05","2021/2022","Midfielder","Manchester United",854,420,434,"Brazil",10,5,5,1,1,0,0,0,0,0,0,2,0,2,13,10,3,4,0,114,251,-1
"2620","Gabriel dos Santos Magalhães",23,"1997","12","19","2021/2022","Defender","Arsenal",900,540,360,"Brazil",10,6,4,1,0,1,0,0,0,0,0,6,3,3,8,4,4,1,0,120,158,25
"2621","Gabriel Jesus",24,"1997","04","03","2021/2022","Forward","Manchester City",859,398,461,"Brazil",11,5,6,2,1,1,5,3,2,0,0,6,3,3,5,2,3,0,0,72,6,-1
"2622","Gabriel Teodoro Martinelli Silva",20,"2001","06","18","2021/2022","Midfielder","Arsenal",185,114,71,"Brazil",6,5,1,1,1,0,0,0,0,0,0,2,2,0,3,2,1,0,0,-1,-1,-1
"2623","Giovani Lo Celso",25,"1996","04","09","2021/2022","Midfielder","Tottenham Hotspur",210,162,48,"Argentina",7,4,3,0,0,0,0,0,0,0,0,3,1,2,4,4,0,0,0,-1,-1,-1
"2624","Gnaly Maxwell Cornet",25,"1996","09","27","2021/2022","Forward","Burnley",452,185,267,"Côte d'Ivoire",7,3,4,5,2,3,0,0,0,0,0,0,0,0,8,3,5,2,0,1,156,-1
"2625","Granit Xhaka",29,"1992","09","27","2021/2022","Midfielder","Arsenal",297,172,125,"Switzerland",4,2,2,0,0,0,0,0,0,0,0,0,0,0,7,3,4,1,1,238,247,-1
"2626","Grant Hanley",29,"1991","11","20","2021/2022","Defender","Norwich City",1168,628,540,"Scotland",13,7,6,1,1,0,0,0,0,0,0,3,2,1,26,11,15,1,0,139,283,118
"2627","Hakim Ziyech",28,"1993","03","19","2021/2022","Midfielder","Chelsea",300,200,100,"Morocco",6,3,3,0,0,0,1,0,1,0,0,5,2,3,1,1,0,1,0,179,22,-1
"2628","Hamza Choudhury",24,"1997","10","01","2021/2022","Midfielder","Leicester City",60,0,60,"England",1,0,1,0,0,0,0,0,0,0,0,0,0,0,0,0,0,0,0,-1,-1,-1
"2629","Harrison Ashby",0,"1970","01","01","2021/2022","Defender","West Ham United",0,0,0,"England",0,0,0,0,0,0,0,0,0,0,0,0,0,0,0,0,0,0,0,-1,-1,-1
"2630","Harry Kane",28,"1993","07","28","2021/2022","Forward","Tottenham Hotspur",918,450,468,"England",11,5,6,1,0,1,1,0,1,0,0,3,1,2,15,7,8,2,0,121,114,-1
"2631","Harry Maguire",28,"1993","03","05","2021/2022","Defender","Manchester United",945,426,519,"England",11,5,6,0,0,0,0,0,0,0,0,2,0,2,16,9,7,5,1,244,250,85
"2632","Harry Tyrer",0,"1970","01","01","2021/2022","Goalkeeper","Everton",0,0,0,"England",0,0,0,0,0,0,0,0,0,0,0,0,0,0,0,0,0,0,0,-1,-1,-1
"2633","Harry Winks",25,"1996","02","02","2021/2022","Midfielder","Tottenham Hotspur",150,90,60,"England",3,1,2,0,0,0,0,0,0,0,0,1,0,1,1,1,0,0,0,-1,-1,-1
"2634","Harvey Elliot",0,"1970","01","01","2021/2022","Forward","Liverpool",250,180,70,"England",4,2,2,0,0,0,0,0,0,0,0,3,1,2,1,1,0,0,0,-1,-1,-1
"2635","Harvey Lewis Barnes",23,"1997","12","09","2021/2022","Midfielder","Leicester City",796,415,381,"England",11,6,5,1,0,1,1,0,1,0,0,1,1,0,15,7,8,2,0,111,105,-1
"2636","Hayden Roberts",0,"1970","01","01","2021/2022","Defender","Brighton & Hove Albion",0,0,0,"England",0,0,0,0,0,0,0,0,0,0,0,0,0,0,0,0,0,0,0,-1,-1,-1
"2637","Hector Bellerin",26,"1995","03","19","2021/2022","Defender","Arsenal",0,0,0,"Spain",0,0,0,0,0,0,0,0,0,0,0,0,0,0,0,0,0,0,0,-1,-1,-1
"2638","Héctor Junior Firpo Adames",25,"1996","08","22","2021/2022","Defender","Leeds United",585,374,211,"Dominican Republic",9,5,4,0,0,0,0,0,0,0,0,3,2,1,11,5,6,3,0,256,262,98
"2639","Hee-Chan Hwang",25,"1996","01","26","2021/2022","Forward","Wolverhampton Wanderers",783,311,472,"South Korea",10,4,6,4,2,2,0,0,0,0,0,4,1,3,6,2,4,0,0,21,194,-1
"2640","Hélder Wander Sousa Azevedo Costa",27,"1994","01","12","2021/2022","Midfielder","Leeds United",20,0,20,"Portugal",1,0,1,0,0,0,0,0,0,0,0,0,0,0,0,0,0,0,0,-1,-1,-1
"2641","Heung-Min Son",29,"1992","07","08","2021/2022","Forward","Tottenham Hotspur",965,538,427,"South Korea",11,6,5,4,2,2,1,1,0,0,0,4,2,2,13,7,6,0,0,32,117,-1
"2642","Hugo Lloris",34,"1986","12","26","2021/2022","Goalkeeper","Tottenham Hotspur",1080,540,540,"France",12,6,6,0,0,0,0,0,0,0,0,4,2,2,15,7,8,0,0,183,196,63
"2643","Ibrahim Halil Dervisoglu",21,"1999","12","08","2021/2022","Forward","Brentford",0,0,0,"Turkey",0,0,0,0,0,0,0,0,0,0,0,0,0,0,0,0,0,0,0,-1,-1,-1
"2644","Ibrahima Diallo",22,"1999","03","08","2021/2022","Midfielder","Southampton",408,251,157,"France",10,5,5,0,0,0,1,1,0,0,0,4,3,1,7,2,5,0,0,302,52,-1
"2645","Ibrahima Konaté",22,"1999","05","25","2021/2022","Defender","Liverpool",360,270,90,"France",4,3,1,0,0,0,0,0,0,0,0,3,2,1,2,2,0,0,0,148,210,16
"2646","İlkay Gündoğan",31,"1990","10","24","2021/2022","Midfielder","Manchester City",774,429,345,"Germany",9,5,4,3,2,1,1,1,0,0,0,6,4,2,1,0,1,1,0,34,100,-1
"2647","Illan Meslier",21,"2000","03","02","2021/2022","Goalkeeper","Leeds United",1260,630,630,"France",14,7,7,0,0,0,0,0,0,0,0,3,2,1,18,7,11,1,0,251,257,67
"2648","Imran Louza",22,"1999","05","01","2021/2022","Midfielder","Watford",169,77,92,"France",3,1,2,0,0,0,0,0,0,0,0,0,0,0,6,1,5,1,0,-1,-1,-1
"2649","Isaac Hayden",26,"1995","03","22","2021/2022","Midfielder","Newcastle United",852,354,498,"England",12,5,7,1,0,1,0,0,0,0,0,0,0,0,19,10,9,3,0,113,155,-1
"2650","Ismaïla Sarr",23,"1998","02","25","2021/2022","Midfielder","Watford",1032,518,514,"Senegal",12,6,6,5,3,2,0,0,0,0,1,0,0,0,18,10,8,1,0,24,273,-1
"2651","Issa Diop",24,"1997","01","09","2021/2022","Defender","West Ham United",0,0,0,"France",0,0,0,0,0,0,0,0,0,0,0,0,0,0,0,0,0,0,0,-1,-1,-1
"2652","Ivan Toney",25,"1996","03","16","2021/2022","Forward","Brentford",1170,630,540,"England",13,7,6,4,1,3,2,1,1,2,0,4,2,2,16,8,8,2,0,45,83,-1
"2653","Jack Butland",28,"1993","03","10","2021/2022","Goalkeeper","Crystal Palace",0,0,0,"England",0,0,0,0,0,0,0,0,0,0,0,0,0,0,0,0,0,0,0,-1,-1,-1
"2654","Jack Cork",32,"1989","06","25","2021/2022","Midfielder","Burnley",317,85,232,"England",4,1,3,0,0,0,0,0,0,0,0,0,0,0,8,2,6,1,0,230,212,-1
"2655","Jack Grealish",26,"1995","09","10","2021/2022","Midfielder","Manchester City",743,333,410,"England",9,4,5,1,1,0,2,1,1,0,0,5,3,2,3,1,2,1,0,107,35,-1
"2656","Jack Harrison",24,"1996","11","20","2021/2022","Midfielder","Leeds United",824,331,493,"England",11,5,6,0,0,0,1,0,1,0,0,1,0,1,17,7,10,1,0,255,104,-1
"2657","Jack Jenkins",0,"1970","01","01","2021/2022","Midfielder","Leeds United",0,0,0,"England",0,0,0,0,0,0,0,0,0,0,0,0,0,0,0,0,0,0,0,-1,-1,-1
"2658","Jack Stephens",27,"1994","01","27","2021/2022","Defender","Southampton",397,180,217,"England",5,2,3,0,0,0,0,0,0,0,0,2,1,1,5,1,4,2,0,296,296,54
"2659","Jacob Murphy",26,"1995","02","24","2021/2022","Midfielder","Newcastle United",530,283,247,"England",11,5,6,1,1,0,1,1,0,0,0,0,0,0,12,8,4,2,0,86,69,-1
"2660","Jacob Ramsey",20,"2001","05","28","2021/2022","Midfielder","Aston Villa",666,295,371,"England",12,5,7,1,0,1,0,0,0,0,0,4,3,1,7,3,4,2,0,99,279,-1
"2661","Jaden Philogene-Bidace",0,"1970","01","01","2021/2022","Midfielder","Aston Villa",4,4,0,"England",1,1,0,0,0,0,0,0,0,0,0,1,1,0,0,0,0,0,0,-1,-1,-1
"2662","Jadon Sancho",21,"2000","03","25","2021/2022","Midfielder","Manchester United",497,158,339,"England",10,4,6,1,0,1,0,0,0,0,0,1,0,1,5,2,3,0,0,84,255,-1
"2663","Jaïro Riedewald",25,"1996","09","09","2021/2022","Defender","Crystal Palace",101,0,101,"Netherlands",2,0,2,0,0,0,0,0,0,0,0,0,0,0,5,0,5,0,0,-1,-1,-1
"2664","Jakob Sørensen",23,"1998","03","03","2021/2022","Midfielder","Norwich City",0,0,0,"Denmark",0,0,0,0,0,0,0,0,0,0,0,0,0,0,0,0,0,0,0,-1,-1,-1
"2665","Jakub Moder",22,"1999","04","07","2021/2022","Midfielder","Brighton & Hove Albion",680,344,336,"Poland",12,6,6,0,0,0,1,0,1,0,0,5,3,2,9,5,4,1,0,216,96,-1
"2666","Jamal Baptiste",18,"2003","11","11","2021/2022","Defender","West Ham United",0,0,0,"England",0,0,0,0,0,0,0,0,0,0,0,0,0,0,0,0,0,0,0,-1,-1,-1
"2667","Jamal Lascelles",27,"1993","11","11","2021/2022","Defender","Newcastle United",900,450,450,"England",10,5,5,1,1,0,0,0,0,0,0,0,0,0,20,11,9,5,0,119,159,120
"2668","Jamal Lewis",23,"1998","01","25","2021/2022","Midfielder","Newcastle United",96,90,6,"Northern Ireland",2,1,1,0,0,0,0,0,0,0,0,0,0,0,1,1,0,0,0,-1,-1,-1
"2669","James Maddison",24,"1996","11","23","2021/2022","Midfielder","Leicester City",742,422,320,"England",13,7,6,2,1,1,2,2,0,0,0,1,1,0,14,7,7,0,0,64,39,-1
"2670","James McArthur",34,"1987","10","07","2021/2022","Midfielder","Crystal Palace",953,530,423,"Scotland",11,6,5,0,0,0,1,1,0,0,0,4,3,1,10,3,7,3,0,224,125,-1
"2671","James Mcatee",0,"1970","01","01","2021/2022","Midfielder","Manchester City",3,3,0,"England",1,1,0,0,0,0,0,0,0,0,0,1,1,0,0,0,0,0,0,-1,-1,-1
"2672","James Milner",35,"1986","01","04","2021/2022","Midfielder","Liverpool",391,191,200,"England",6,3,3,0,0,0,1,0,1,0,0,5,2,3,1,1,0,2,0,262,50,-1
"2673","James Morris",19,"2001","11","23","2021/2022","Defender","Watford",0,0,0,"England",0,0,0,0,0,0,0,0,0,0,0,0,0,0,0,0,0,0,0,-1,-1,-1
"2674","James Storer",0,"1970","01","01","2021/2022","Goalkeeper","Wolverhampton Wanderers",0,0,0,"England",0,0,0,0,0,0,0,0,0,0,0,0,0,0,0,0,0,0,0,-1,-1,-1
"2675","James Tarkowski",28,"1992","11","19","2021/2022","Defender","Burnley",1080,540,540,"England",12,6,6,1,1,0,2,2,0,0,0,1,1,0,20,8,12,5,0,140,76,96
"2676","James Tomkins",32,"1989","03","29","2021/2022","Defender","Crystal Palace",188,90,98,"England",3,1,2,0,0,0,0,0,0,0,0,0,0,0,2,2,0,0,0,-1,-1,-1
"2677","James Ward-Prowse",27,"1994","11","01","2021/2022","Midfielder","Southampton",967,360,607,"England",11,4,7,2,0,2,0,0,0,2,0,4,2,2,13,2,11,3,1,77,301,-1
"2678","Jamie Shackelton",22,"1999","10","08","2021/2022","Midfielder","Leeds United",531,300,231,"England",9,4,5,0,0,0,0,0,0,0,0,2,1,1,4,2,2,3,0,247,237,-1
"2679","Jamie Vardy",34,"1987","01","11","2021/2022","Forward","Leicester City",1117,630,487,"England",13,7,6,9,6,3,1,0,1,0,0,1,1,0,21,12,9,2,0,5,138,-1
"2680","Jan Bednarek",25,"1996","04","12","2021/2022","Defender","Southampton",810,404,406,"Poland",10,5,5,0,0,0,0,0,0,0,0,4,2,2,12,4,8,3,0,305,306,74
"2681","Jannik Vestergaard",29,"1992","08","03","2021/2022","Defender","Leicester City",383,181,202,"Denmark",7,4,3,0,0,0,0,0,0,0,0,1,1,0,6,2,4,1,0,311,312,78
"2682","Japhet Tanganga",22,"1999","03","31","2021/2022","Defender","Tottenham Hotspur",435,241,194,"England",6,3,3,0,0,0,0,0,0,0,0,3,2,1,4,1,3,3,1,185,198,27
"2683","Jarrad Branthwaite",19,"2002","06","27","2021/2022","Midfielder","Everton",0,0,0,"England",0,0,0,0,0,0,0,0,0,0,0,0,0,0,0,0,0,0,0,-1,-1,-1
"2684","Jarrod Bowen",24,"1996","12","20","2021/2022","Forward","West Ham United",1053,523,530,"England",13,6,7,2,1,1,4,3,1,0,0,3,1,2,13,8,5,1,0,87,15,-1
"2685","Jason Steele",31,"1990","08","18","2021/2022","Goalkeeper","Brighton & Hove Albion",90,0,90,"England",1,0,1,0,0,0,0,0,0,0,0,0,0,0,2,0,2,0,0,-1,-1,-1
"2686","Javier Manquillo Gaitán",27,"1994","05","05","2021/2022","Defender","Newcastle United",678,351,327,"Spain",8,4,4,1,0,1,2,1,1,0,0,0,0,0,14,8,6,2,0,104,28,111
"2687","Jay Rodriguez",32,"1989","07","29","2021/2022","Forward","Burnley",221,145,76,"England",9,4,5,0,0,0,1,0,1,0,0,1,1,0,0,0,0,2,0,-1,-1,-1
"2688","Jean-Philippe Gbamin",26,"1995","09","25","2021/2022","Midfielder","Everton",46,0,46,"Côte d'Ivoire",2,1,1,0,0,0,0,0,0,0,0,1,1,0,2,0,2,0,0,-1,-1,-1
"2689","Jean-Philippe Mateta",24,"1997","06","28","2021/2022","Forward","Crystal Palace",61,4,57,"France",2,1,1,0,0,0,0,0,0,0,0,0,0,0,2,0,2,0,0,-1,-1,-1
"2690","Jed Steer",29,"1992","09","22","2021/2022","Goalkeeper","Aston Villa",90,0,90,"England",1,0,1,0,0,0,0,0,0,0,0,0,0,0,2,0,2,0,0,-1,-1,-1
"2691","Jeff Hendrick",29,"1992","01","31","2021/2022","Midfielder","Newcastle United",60,0,60,"Republic of Ireland",2,0,2,1,0,1,0,0,0,0,0,0,0,0,1,0,1,0,0,-1,-1,-1
"2692","Jeffrey Schlupp",28,"1992","12","23","2021/2022","Defender","Crystal Palace",283,118,165,"Ghana",10,5,5,1,1,0,0,0,0,0,0,3,2,1,2,0,2,0,0,40,231,20
"2693","Jeremy Leonel Sarmiento Morante",19,"2002","06","16","2021/2022","Forward","Brighton & Hove Albion",8,8,0,"England",1,1,0,0,0,0,0,0,0,0,0,1,1,0,0,0,0,0,0,-1,-1,-1
"2694","Jeremy Ngakia",21,"2000","09","07","2021/2022","Forward","Watford",375,229,146,"England",7,4,3,0,0,0,0,0,0,0,0,0,0,0,5,3,2,0,0,268,274,-1
"2695","Jesse Lingard",28,"1992","12","15","2021/2022","Midfielder","Manchester United",76,24,52,"England",7,1,6,2,1,1,0,0,0,0,0,1,0,1,1,0,1,0,0,-1,-1,-1
"2696","Jesuran Rak-Sakyi",0,"1970","01","01","2021/2022","Forward","Crystal Palace",14,0,14,"England",1,0,1,0,0,0,0,0,0,0,0,0,0,0,0,0,0,0,0,-1,-1,-1
"2697","Joachim Andersen",25,"1996","05","31","2021/2022","Defender","Crystal Palace",1023,540,483,"Denmark",12,6,6,0,0,0,1,0,1,0,0,4,3,1,13,3,10,3,0,227,129,55
"2698","João Cancelo",27,"1994","05","27","2021/2022","Defender","Manchester City",1158,618,540,"Portugal",13,7,6,0,0,0,3,1,2,0,0,8,5,3,5,1,4,4,0,194,48,8
"2699","João Moutinho",35,"1986","09","08","2021/2022","Midfielder","Wolverhampton Wanderers",1111,522,589,"Portugal",13,6,7,0,0,0,0,0,0,0,0,4,1,3,11,6,5,2,0,315,317,-1
"2700","João Pedro Junqueira de Jesus",20,"2001","09","26","2021/2022","Forward","Watford",235,106,129,"Brazil",8,4,4,1,1,0,1,0,1,0,0,0,0,0,2,1,1,1,0,-1,-1,-1
"2701","Joe Gelhardt",19,"2002","05","04","2021/2022","Midfielder","Leeds United",128,28,100,"England",3,1,2,0,0,0,0,0,0,0,0,0,0,0,2,0,2,1,0,-1,-1,-1
"2702","Joe Gomez",24,"1997","05","23","2021/2022","Defender","Liverpool",12,12,0,"England",2,2,0,0,0,0,0,0,0,0,0,1,1,0,1,1,0,0,0,-1,-1,-1
"2703","Joe Rodon",24,"1997","10","22","2021/2022","Defender","Tottenham Hotspur",78,0,78,"Wales",1,0,1,0,0,0,0,0,0,0,0,0,0,0,2,0,2,0,0,-1,-1,-1
"2704","Joe White",19,"2002","10","01","2021/2022","Midfielder","Newcastle United",0,0,0,"England",0,0,0,0,0,0,0,0,0,0,0,0,0,0,0,0,0,0,0,-1,-1,-1
"2705","Joel Matip",30,"1991","08","08","2021/2022","Defender","Liverpool",810,360,450,"Cameroon",9,4,5,0,0,0,0,0,0,0,0,5,2,3,9,3,6,0,0,288,266,45
"2706","Joël Veltman",29,"1992","01","15","2021/2022","Defender","Brighton & Hove Albion",823,494,329,"Netherlands",10,6,4,0,0,0,1,0,1,0,0,4,2,2,9,6,3,4,0,164,106,44
"2707","Joel Ward",32,"1989","10","29","2021/2022","Defender","Crystal Palace",1260,630,630,"England",14,7,7,0,0,0,0,0,0,0,0,4,3,1,17,5,12,5,0,222,230,57
"2708","Joelinton Cassio Apolinário de Lira",25,"1996","08","14","2021/2022","Forward","Newcastle United",760,386,374,"Brazil",13,6,7,1,1,0,1,1,0,0,0,0,0,0,17,9,8,2,0,106,98,-1
"2709","Johann Berg Guðmunds­son",31,"1990","10","27","2021/2022","Midfielder","Burnley",720,420,300,"Iceland",12,6,6,0,0,0,1,0,1,0,0,1,1,0,14,7,7,2,0,205,92,-1
"2710","John McGinn",27,"1994","10","18","2021/2022","Midfielder","Aston Villa",1030,400,630,"Scotland",12,5,7,3,1,2,1,1,0,0,0,4,3,1,17,6,11,4,0,60,119,-1
"2711","John Ruddy",35,"1986","10","24","2021/2022","Goalkeeper","Wolverhampton Wanderers",0,0,0,"England",0,0,0,0,0,0,0,0,0,0,0,0,0,0,0,0,0,0,0,-1,-1,-1
"2712","John Stones",27,"1994","05","28","2021/2022","Defender","Manchester City",301,211,90,"England",4,3,1,0,0,0,0,0,0,0,0,3,2,1,1,1,0,0,0,201,173,4
"2713","Jonjo Shelvey",29,"1992","02","27","2021/2022","Midfielder","Newcastle United",467,289,178,"England",7,5,2,0,0,0,0,0,0,0,0,0,0,0,11,8,3,4,1,154,151,-1
"2714","Jonjoe Kenny",24,"1997","03","15","2021/2022","Defender","Everton",10,0,10,"England",1,0,1,0,0,0,0,0,0,0,0,0,0,0,0,0,0,0,0,-1,-1,-1
"2715","Jonny Evans",33,"1988","01","03","2021/2022","Defender","Leicester City",567,387,180,"Northern Ireland",7,5,2,0,0,0,1,1,0,0,0,0,0,0,12,10,2,2,0,171,79,115
"2716","Jordan Ayew",30,"1991","09","11","2021/2022","Forward","Crystal Palace",805,251,554,"Ghana",13,6,7,0,0,0,1,0,1,0,0,4,3,1,14,2,12,1,0,226,108,-1
"2717","Jordan Henderson",31,"1990","06","17","2021/2022","Midfielder","Liverpool",900,513,387,"England",12,7,5,1,1,0,2,0,2,0,0,7,4,3,11,5,6,1,0,122,58,-1
"2718","Jordan Pickford",27,"1994","03","07","2021/2022","Goalkeeper","Everton",1080,540,540,"England",12,6,6,0,0,0,0,0,0,0,0,3,2,1,16,7,9,1,0,228,233,72
"2719","Jorginho",29,"1991","12","20","2021/2022","Midfielder","Chelsea",905,471,434,"Italy",12,7,5,2,1,1,1,1,0,2,0,7,3,4,4,3,1,1,0,75,112,-1
"2720","José Diogo Dalot Teixeira",22,"1999","03","18","2021/2022","Defender","Manchester United",90,84,6,"Portugal",4,2,2,0,0,0,0,0,0,0,0,1,0,1,1,1,0,1,0,-1,-1,-1
"2721","José Pedro Malheiro de Sá",28,"1993","01","17","2021/2022","Goalkeeper","Wolverhampton Wanderers",1170,540,630,"Portugal",13,6,7,0,0,0,1,0,1,0,0,4,1,3,11,6,5,1,0,313,134,32
"2722","Joseph Willock",22,"1999","08","20","2021/2022","Midfielder","Newcastle United",826,419,407,"England",12,6,6,0,0,0,0,0,0,0,0,0,0,0,19,10,9,0,0,200,182,-1
"2723","Josh Brownhill",25,"1995","12","19","2021/2022","Midfielder","Burnley",1001,461,540,"England",12,6,6,0,0,0,0,0,0,0,0,1,1,0,18,6,12,4,0,209,215,-1
"2724","Josh Wilson-Esbrand",0,"1970","01","01","2021/2022","Midfielder","Manchester City",0,0,0,"England",0,0,0,0,0,0,0,0,0,0,0,0,0,0,0,0,0,0,0,-1,-1,-1
"2725","Joshua King",29,"1992","01","15","2021/2022","Forward","Watford",818,323,495,"Norway",11,4,7,5,1,4,2,1,1,1,0,0,0,0,13,3,10,2,0,10,53,-1
"2726","Joshua Sargent",21,"2000","02","20","2021/2022","Forward","Norwich City",706,365,341,"USA",13,7,6,0,0,0,0,0,0,0,0,3,2,1,14,5,9,0,0,285,289,-1
"2727","Juan Camilo Hernández Suárez",22,"1999","04","22","2021/2022","Forward","Watford",484,219,265,"Colombia",10,5,5,1,1,0,1,0,1,0,0,0,0,0,14,8,6,0,0,81,63,-1
"2728","Juan Mata",33,"1988","04","28","2021/2022","Midfielder","Manchester United",0,0,0,"Spain",0,0,0,0,0,0,0,0,0,0,0,0,0,0,0,0,0,0,0,-1,-1,-1
"2729","Juraj Kucka",34,"1987","02","26","2021/2022","Midfielder","Watford",852,403,449,"Slovakia",10,5,5,1,0,1,0,0,0,0,0,0,0,0,14,8,6,4,1,118,270,-1
"2730","Jürgen Locadia",28,"1993","11","07","2021/2022","Forward","Brighton & Hove Albion",22,22,0,"Netherlands",1,1,0,0,0,0,0,0,0,0,0,1,1,0,0,0,0,0,0,-1,-1,-1
"2731","Kai Havertz",22,"1999","06","11","2021/2022","Midfielder","Chelsea",634,262,372,"Germany",11,5,6,2,1,1,0,0,0,0,0,8,3,5,2,1,1,0,0,50,225,-1
"2732","Kaide Gordon",0,"1970","01","01","2021/2022","Forward","Liverpool",0,0,0,"England",0,0,0,0,0,0,0,0,0,0,0,0,0,0,0,0,0,0,0,-1,-1,-1
"2733","Kalvin Phillips",25,"1995","12","02","2021/2022","Midfielder","Leeds United",946,540,406,"England",11,6,5,0,0,0,1,0,1,0,0,3,2,1,11,6,5,2,0,259,111,-1
"2734","Karl Darlow",31,"1990","10","08","2021/2022","Goalkeeper","Newcastle United",720,360,360,"England",8,4,4,0,0,0,0,0,0,0,0,0,0,0,15,10,5,1,0,168,208,113
"2735","Karl Jakob Hein",19,"2002","04","13","2021/2022","Goalkeeper","Arsenal",0,0,0,"Estonia",0,0,0,0,0,0,0,0,0,0,0,0,0,0,0,0,0,0,0,-1,-1,-1
"2736","Kasper Schmeichel",35,"1986","11","05","2021/2022","Goalkeeper","Leicester City",1170,630,540,"Denmark",13,7,6,0,0,0,0,0,0,0,0,1,1,0,23,12,11,1,0,293,295,101
"2737","Keinan Davis",23,"1998","02","13","2021/2022","Midfielder","Aston Villa",11,0,11,"England",1,0,1,0,0,0,0,0,0,0,0,0,0,0,0,0,0,0,0,-1,-1,-1
"2738","Kelechi Iheanacho",25,"1996","10","03","2021/2022","Forward","Leicester City",438,230,208,"Nigeria",11,6,5,1,0,1,2,2,0,0,0,1,1,0,7,4,3,0,0,73,11,-1
"2739","Ken Sema",28,"1993","09","30","2021/2022","Midfielder","Watford",287,147,140,"Sweden",6,3,3,0,0,0,0,0,0,0,0,0,0,0,4,2,2,1,0,266,271,-1
"2740","Kenny Mclean",29,"1992","01","08","2021/2022","Midfielder","Norwich City",1124,540,584,"Scotland",13,6,7,0,0,0,0,0,0,0,0,3,2,1,22,8,14,1,0,286,290,-1
"2741","Kepa Arrizabalaga",27,"1994","10","03","2021/2022","Goalkeeper","Chelsea",90,0,90,"Spain",1,0,1,0,0,0,0,0,0,0,0,1,0,1,0,0,0,0,0,-1,-1,-1
"2742","Kevin De Bruyne",30,"1991","06","28","2021/2022","Midfielder","Manchester City",453,168,285,"Belgium",8,3,5,2,1,1,0,0,0,0,0,4,2,2,4,1,3,0,0,29,172,-1
"2743","Kevin Long",31,"1990","08","18","2021/2022","Defender","Burnley",0,0,0,"Republic of Ireland",0,0,0,0,0,0,0,0,0,0,0,0,0,0,0,0,0,0,0,-1,-1,-1
"2744","Ki-Jana Hoever",19,"2002","01","18","2021/2022","Defender","Wolverhampton Wanderers",100,0,100,"Netherlands",4,0,4,0,0,0,0,0,0,0,0,2,0,2,1,0,1,1,0,-1,-1,-1
"2745","Kieran Dowell",24,"1997","10","10","2021/2022","Midfielder","Norwich City",217,81,136,"England",5,3,2,0,0,0,0,0,0,0,0,1,1,0,3,2,1,0,0,-1,-1,-1
"2746","Kieran Tierney",24,"1997","06","05","2021/2022","Defender","Arsenal",684,336,348,"Scotland",8,4,4,0,0,0,0,0,0,0,0,3,1,2,12,5,7,0,0,236,245,92
"2747","Kiernan Dewsbury-Hall",23,"1998","09","06","2021/2022","Midfielder","Leicester City",34,17,17,"England",4,2,2,0,0,0,0,0,0,0,0,0,0,0,0,0,0,0,0,-1,-1,-1
"2748","Kjell Scherpen",0,"1970","01","01","2021/2022","Goalkeeper","Brighton & Hove Albion",0,0,0,"Netherlands",0,0,0,0,0,0,0,0,0,0,0,0,0,0,0,0,0,0,0,-1,-1,-1
"2749","Konstantinos Tsimikas",25,"1996","05","12","2021/2022","Defender","Liverpool",390,274,116,"Greece",6,4,2,0,0,0,1,1,0,0,0,5,3,2,0,0,0,1,0,289,46,1
"2750","Kortney Hause",26,"1995","07","16","2021/2022","Defender","Aston Villa",261,91,170,"England",4,2,2,1,0,1,0,0,0,0,0,1,0,1,6,4,2,0,0,-1,-1,-1
"2751","Kristoffer Ajer",23,"1998","04","17","2021/2022","Defender","Brentford",565,295,270,"Norway",7,4,3,0,0,0,0,0,0,0,0,3,1,2,5,4,1,1,0,234,240,26
"2752","Kristoffer Klaesson",20,"2000","11","27","2021/2022","Goalkeeper","Leeds United",0,0,0,"Norway",0,0,0,0,0,0,0,0,0,0,0,0,0,0,0,0,0,0,0,-1,-1,-1
"2753","Kurt Zouma",27,"1994","10","27","2021/2022","Defender","West Ham United",810,360,450,"France",9,4,5,1,1,0,0,0,0,0,0,2,1,1,9,5,4,1,0,115,228,46
"2754","Kwadwo Baah",0,"1970","01","01","2021/2022","Forward","Watford",0,0,0,"England",0,0,0,0,0,0,0,0,0,0,0,0,0,0,0,0,0,0,0,-1,-1,-1
"2755","Kyle Walker",31,"1990","05","28","2021/2022","Defender","Manchester City",946,496,450,"England",11,6,5,0,0,0,0,0,0,0,0,7,4,3,5,2,3,1,0,197,176,15
"2756","Kyle Walker-Peters",24,"1997","04","13","2021/2022","Defender","Southampton",627,175,452,"England",9,3,6,0,0,0,0,0,0,0,0,3,1,2,7,1,6,3,0,304,305,48
"2757","Lamar Bogarde",17,"2004","01","05","2021/2022","Forward","Aston Villa",0,0,0,"Netherlands",0,0,0,0,0,0,0,0,0,0,0,0,0,0,0,0,0,0,0,-1,-1,-1
"2758","Leander Dendoncker",26,"1995","04","15","2021/2022","Midfielder","Wolverhampton Wanderers",333,25,308,"Belgium",9,4,5,0,0,0,1,0,1,0,0,3,1,2,2,0,2,1,0,318,26,-1
"2759","Leandro Trossard",26,"1994","12","04","2021/2022","Forward","Brighton & Hove Albion",1138,612,526,"Belgium",13,7,6,3,1,2,1,1,0,1,0,5,3,2,13,7,6,1,0,63,135,-1
"2760","Leo Fuhr Hjelde",18,"2003","08","26","2021/2022","Defender","Leeds United",0,0,0,"Norway",0,0,0,0,0,0,0,0,0,0,0,0,0,0,0,0,0,0,0,-1,-1,-1
"2761","Leon Bailey Butler",24,"1997","08","09","2021/2022","Forward","Aston Villa",392,117,275,"Jamaica",8,3,5,1,1,0,2,0,2,0,0,2,2,0,5,2,3,1,0,65,9,-1
"2762","Lewis Bate",0,"1970","01","01","2021/2022","Midfielder","Leeds United",0,0,0,"England",0,0,0,0,0,0,0,0,0,0,0,0,0,0,0,0,0,0,0,-1,-1,-1
"2763","Lewis Dunk",29,"1991","11","21","2021/2022","Defender","Brighton & Hove Albion",1170,630,540,"England",13,7,6,0,0,0,0,0,0,0,0,5,3,2,13,7,6,0,0,212,219,47
"2764","Lewis Norman Dobbin",18,"2003","01","03","2021/2022","Midfielder","Everton",1,1,0,"England",2,1,1,0,0,0,0,0,0,0,0,1,1,0,0,0,0,0,0,-1,-1,-1
"2765","Lewis Richardson",18,"2003","02","07","2021/2022","Forward","Burnley",0,0,0,"England",0,0,0,0,0,0,0,0,0,0,0,0,0,0,0,0,0,0,0,-1,-1,-1
"2766","Liam Cooper",30,"1991","08","30","2021/2022","Defender","Leeds United",1260,630,630,"Scotland",14,7,7,0,0,0,1,1,0,0,0,3,2,1,18,7,11,4,0,252,146,66
"2767","Liam McCarron",20,"2001","03","07","2021/2022","Forward","Leeds United",0,0,0,"England",0,0,0,0,0,0,0,0,0,0,0,0,0,0,0,0,0,0,0,-1,-1,-1
"2768","Louie Moulden",19,"2002","01","06","2021/2022","Goalkeeper","Wolverhampton Wanderers",0,0,0,"England",0,0,0,0,0,0,0,0,0,0,0,0,0,0,0,0,0,0,0,-1,-1,-1
"2769","Lucas Digne",28,"1993","07","20","2021/2022","Defender","Everton",1080,540,540,"France",12,6,6,0,0,0,0,0,0,0,0,3,2,1,17,7,10,3,0,260,235,79
"2770","Lucas Rodrigues Moura da Silva",29,"1992","08","13","2021/2022","Midfielder","Tottenham Hotspur",841,343,498,"Brazil",11,5,6,0,0,0,1,1,0,0,0,4,2,2,11,3,8,2,0,186,107,-1
"2771","Luka Milivojević",30,"1991","04","07","2021/2022","Midfielder","Crystal Palace",472,318,154,"Serbia",7,5,2,0,0,0,0,0,0,0,0,1,1,0,8,4,4,1,0,166,187,-1
"2772","Lukas Rupp",30,"1991","01","08","2021/2022","Midfielder","Norwich City",399,173,226,"Germany",9,5,4,0,0,0,0,0,0,0,0,3,2,1,8,4,4,0,0,280,285,-1
"2773","Luke Ayling",30,"1991","08","25","2021/2022","Defender","Leeds United",449,180,269,"England",5,2,3,1,0,1,0,0,0,0,0,0,0,0,11,4,7,0,0,76,258,126
"2774","Luke Cundle",0,"1970","01","01","2021/2022","Midfielder","Wolverhampton Wanderers",0,0,0,"England",0,0,0,0,0,0,0,0,0,0,0,0,0,0,0,0,0,0,0,-1,-1,-1
"2775","Luke Mbete-Tatu",18,"2003","09","18","2021/2022","Defender","Manchester City",0,0,0,"England",0,0,0,0,0,0,0,0,0,0,0,0,0,0,0,0,0,0,0,-1,-1,-1
"2776","Luke Shaw",26,"1995","07","12","2021/2022","Defender","Manchester United",1001,467,534,"England",12,6,6,0,0,0,1,1,0,0,0,2,0,2,17,10,7,4,0,245,121,88
"2777","Luke Thomas",0,"1970","01","01","2021/2022","Midfielder","Leicester City",450,270,180,"England",5,3,2,0,0,0,0,0,0,0,0,1,1,0,9,4,5,0,0,309,310,-1
"2778","Lyanco",24,"1997","02","01","2021/2022","Defender","Southampton",141,34,107,"Brazil",4,1,3,0,0,0,0,0,0,0,0,2,1,1,5,0,5,0,0,-1,-1,-1
"2779","Mads Bech Sørensen",22,"1999","01","07","2021/2022","Defender","Brentford",19,19,0,"Denmark",1,1,0,0,0,0,0,0,0,0,0,1,1,0,0,0,0,0,0,-1,-1,-1
"2780","Mads Bidstrup",20,"2001","02","25","2021/2022","Midfielder","Brentford",22,10,12,"Denmark",3,1,2,0,0,0,0,0,0,0,0,2,1,1,0,0,0,0,0,-1,-1,-1
"2781","Mads Roerslev Rasmussen",22,"1999","06","24","2021/2022","Defender","Brentford",150,42,108,"Denmark",5,2,3,0,0,0,0,0,0,0,0,2,1,1,3,0,3,0,0,-1,-1,-1
"2782","Malang Sarr",22,"1999","01","23","2021/2022","Defender","Chelsea",90,0,90,"France",1,0,1,0,0,0,0,0,0,0,0,1,0,1,0,0,0,0,0,-1,-1,-1
"2783","Manuel Lanzini",28,"1993","02","15","2021/2022","Midfielder","West Ham United",109,18,91,"Argentina",7,3,4,1,0,1,1,0,1,0,0,2,1,1,1,1,0,0,0,-1,-1,-1
"2784","Marc Albrighton",31,"1989","11","18","2021/2022","Midfielder","Leicester City",295,195,100,"England",5,3,2,1,0,1,0,0,0,0,0,0,0,0,5,4,1,1,0,44,313,-1
"2785","Marc Cucurella Saseta",23,"1998","07","22","2021/2022","Defender","Brighton & Hove Albion",842,450,392,"Spain",10,5,5,0,0,0,0,0,0,0,0,4,2,2,8,5,3,3,0,172,152,33
"2786","Marc Guehi",21,"2000","07","13","2021/2022","Defender","Crystal Palace",1260,630,630,"England",14,7,7,2,1,1,0,0,0,0,0,4,3,1,17,5,12,2,0,96,232,59
"2787","Marcos Alonso",30,"1990","12","28","2021/2022","Defender","Chelsea",614,344,270,"Spain",7,4,3,1,1,0,1,0,1,0,0,4,2,2,3,2,1,2,0,94,86,13
"2788","Marcus Bettinelli",29,"1992","05","24","2021/2022","Goalkeeper","Chelsea",0,0,0,"England",0,0,0,0,0,0,0,0,0,0,0,0,0,0,0,0,0,0,0,-1,-1,-1
"2789","Marcus Forss",22,"1999","06","18","2021/2022","Forward","Brentford",171,81,90,"Finland",5,4,1,0,0,0,0,0,0,0,0,1,1,0,4,1,3,0,0,-1,-1,-1
"2790","Marcus Rashford",24,"1997","10","31","2021/2022","Forward","Manchester United",252,85,167,"England",6,2,4,2,0,2,0,0,0,0,0,1,0,1,10,5,5,1,0,-1,-1,-1
"2791","Mark Gillespie",29,"1992","03","27","2021/2022","Goalkeeper","Newcastle United",0,0,0,"England",0,0,0,0,0,0,0,0,0,0,0,0,0,0,0,0,0,0,0,-1,-1,-1
"2792","Mark Noble",34,"1987","05","08","2021/2022","Midfielder","West Ham United",2,2,0,"England",2,2,0,0,0,0,0,0,0,0,1,0,0,0,0,0,0,0,0,-1,-1,-1
"2793","Martin Dúbravka",32,"1989","01","15","2021/2022","Goalkeeper","Newcastle United",180,90,90,"Slovakia",2,1,1,0,0,0,0,0,0,0,0,0,0,0,3,1,2,0,0,-1,-1,-1
"2794","Martin Kelly",31,"1990","04","27","2021/2022","Defender","Crystal Palace",0,0,0,"England",0,0,0,0,0,0,0,0,0,0,0,0,0,0,0,0,0,0,0,-1,-1,-1
"2795","Martin Ødegaard",22,"1998","12","17","2021/2022","Midfielder","Arsenal",659,380,279,"Norway",11,6,5,1,0,1,0,0,0,0,0,6,3,3,9,3,6,1,0,100,181,-1
"2796","Marvelous Nakamba",27,"1994","01","19","2021/2022","Midfielder","Aston Villa",534,280,254,"Zimbabwe",9,5,4,0,0,0,0,0,0,0,0,2,2,0,10,6,4,2,0,274,278,-1
"2797","Mason Greenwood",20,"2001","10","01","2021/2022","Midfielder","Manchester United",801,468,333,"England",10,6,4,4,1,3,0,0,0,0,0,1,0,1,14,10,4,1,0,23,254,-1
"2798","Mason Holgate",25,"1996","10","22","2021/2022","Defender","Everton",278,98,180,"England",4,2,2,0,0,0,0,0,0,0,0,2,1,1,3,1,2,1,1,232,264,42
"2799","Mason Mount",22,"1999","01","10","2021/2022","Midfielder","Chelsea",527,222,305,"England",10,5,5,3,3,0,2,1,1,1,0,6,2,4,1,0,1,0,0,13,16,-1
"2800","Matěj Vydra",29,"1992","05","01","2021/2022","Forward","Burnley",220,111,109,"Czech Republic",10,6,4,1,0,1,1,0,1,0,0,1,1,0,3,2,1,0,0,-1,-1,-1
"2801","Mateo Kovačić",27,"1994","05","06","2021/2022","Midfielder","Chelsea",704,433,271,"Croatia",9,5,4,1,1,0,5,4,1,0,0,6,3,3,2,2,0,1,0,101,3,-1
"2802","Mateusz Klich",31,"1990","06","13","2021/2022","Midfielder","Leeds United",664,348,316,"Poland",9,5,4,1,1,0,1,1,0,0,0,2,2,0,12,4,8,0,0,98,87,-1
"2803","Mathias Jattah-Njie Jørgensen",31,"1990","04","23","2021/2022","Defender","Brentford",427,239,188,"Denmark",7,4,3,1,1,0,0,0,0,0,0,1,0,1,10,6,4,2,0,71,191,123
"2804","Mathias Jensen",25,"1996","01","01","2021/2022","Midfielder","Brentford",431,292,139,"Denmark",7,4,3,0,0,0,1,1,0,0,0,0,0,0,9,5,4,0,0,163,56,-1
"2805","Mathias Normann",25,"1996","05","28","2021/2022","Midfielder","Norwich City",707,368,339,"Norway",9,5,4,1,0,1,1,1,0,0,0,3,2,1,13,5,8,4,0,102,93,-1
"2806","Matt Doherty",29,"1992","01","16","2021/2022","Defender","Tottenham Hotspur",26,7,19,"Republic of Ireland",2,1,1,0,0,0,0,0,0,0,0,2,1,1,0,0,0,0,0,-1,-1,-1
"2807","Matt Ritchie",32,"1989","09","10","2021/2022","Midfielder","Newcastle United",1147,540,607,"Scotland",13,6,7,0,0,0,2,2,0,0,0,0,0,0,27,15,12,5,0,155,80,-1
"2808","Matt Targett",26,"1995","09","18","2021/2022","Defender","Aston Villa",1007,421,586,"England",12,5,7,1,0,1,1,0,1,0,0,3,2,1,17,7,10,2,0,128,120,87
"2809","Matthew Cox",18,"2003","05","02","2021/2022","Goalkeeper","Brentford",0,0,0,"England",0,0,0,0,0,0,0,0,0,0,0,0,0,0,0,0,0,0,0,-1,-1,-1
"2810","Matthew Lowton",32,"1989","06","09","2021/2022","Defender","Burnley",1080,540,540,"England",12,6,6,1,1,0,2,1,1,0,0,1,1,0,20,8,12,1,0,138,77,95
"2811","Matty Cash",24,"1997","08","07","2021/2022","Midfielder","Aston Villa",1155,525,630,"England",13,6,7,1,1,0,0,0,0,0,0,4,3,1,16,5,11,4,0,142,267,-1
"2812","Max Kilman",24,"1997","05","23","2021/2022","Defender","Wolverhampton Wanderers",1170,540,630,"England",13,6,7,1,1,0,0,0,0,0,0,4,1,3,11,6,5,2,0,132,316,31
"2813","Maximillian James Aarons",21,"2000","01","04","2021/2022","Midfielder","Norwich City",1260,630,630,"England",14,7,7,0,0,0,1,1,0,0,0,3,2,1,27,11,16,3,0,279,148,-1
"2814","Maxwell Haygarth",19,"2002","01","21","2021/2022","Midfielder","Brentford",0,0,0,"England",0,0,0,0,0,0,0,0,0,0,0,0,0,0,0,0,0,0,0,-1,-1,-1
"2815","Michael Keane",28,"1993","01","11","2021/2022","Defender","Everton",1170,540,630,"England",13,6,7,1,1,0,2,1,1,0,0,3,2,1,19,7,12,0,0,143,85,81
"2816","Michael Olise",0,"1970","01","01","2021/2022","Midfielder","Crystal Palace",270,205,65,"England",9,5,4,1,1,0,2,0,2,0,0,3,2,1,4,3,1,2,0,-1,-1,-1
"2817","Michail Antonio",31,"1990","03","28","2021/2022","Midfielder","West Ham United",1079,449,630,"England",12,5,7,6,4,2,3,2,1,0,1,3,1,2,12,6,6,4,1,16,33,-1
"2818","Michał Karbownik",20,"2001","03","13","2021/2022","Midfielder","Brighton & Hove Albion",0,0,0,"Poland",0,0,0,0,0,0,0,0,0,0,0,0,0,0,0,0,0,0,0,-1,-1,-1
"2819","Miguel Ángel Almirón Rejala",27,"1994","02","10","2021/2022","Midfielder","Newcastle United",735,278,457,"Paraguay",12,5,7,0,0,0,0,0,0,0,0,0,0,0,18,9,9,1,0,156,157,-1
"2820","Milot Rashica",25,"1996","06","28","2021/2022","Forward","Norwich City",808,531,277,"Kosovo",13,7,6,0,0,0,1,1,0,0,0,3,2,1,21,11,10,0,0,281,102,-1
"2821","Mohamed Elneny",29,"1992","07","11","2021/2022","Midfielder","Arsenal",59,9,50,"Egypt",4,2,2,0,0,0,0,0,0,0,0,2,2,0,2,0,2,0,0,-1,-1,-1
"2822","Mohamed Elyounoussi",27,"1994","08","04","2021/2022","Midfielder","Southampton",746,436,310,"Norway",10,5,5,1,0,1,0,0,0,0,0,5,3,2,6,3,3,1,0,109,304,-1
"2823","Mohamed Saïd Benrahma",26,"1995","08","10","2021/2022","Forward","West Ham United",1049,527,522,"Algeria",13,6,7,3,2,1,3,1,2,0,0,3,1,2,13,7,6,0,0,55,31,-1
"2824","Mohamed Salah",29,"1992","06","15","2021/2022","Forward","Liverpool",1170,630,540,"Egypt",13,7,6,11,4,7,8,3,5,1,0,8,4,4,11,5,6,1,0,3,4,-1
"2825","Mohamed Salisu Abdul Karim",22,"1999","04","17","2021/2022","Defender","Southampton",1133,540,593,"Ghana",13,6,7,0,0,0,0,0,0,0,0,5,3,2,17,4,13,4,0,298,299,75
"2826","Moise Kean",21,"2000","02","28","2021/2022","Forward","Everton",0,0,0,"Italy",1,0,1,0,0,0,0,0,0,0,0,0,0,0,0,0,0,0,0,-1,-1,-1
"2827","Moisés Isaac Caicedo Corozo",20,"2001","02","11","2021/2022","Forward","Brighton & Hove Albion",0,0,0,"Ecuador",0,0,0,0,0,0,0,0,0,0,0,0,0,0,0,0,0,0,0,-1,-1,-1
"2828","Morgan Gibbs-White",21,"2000","01","27","2021/2022","Midfielder","Wolverhampton Wanderers",7,3,4,"England",2,1,1,0,0,0,0,0,0,0,0,0,0,0,0,0,0,1,0,-1,-1,-1
"2829","Morgan Sanson",27,"1994","08","18","2021/2022","Midfielder","Aston Villa",0,0,0,"France",0,0,0,0,0,0,0,0,0,0,0,0,0,0,0,0,0,0,0,-1,-1,-1
"2830","Moussa Djenepo",23,"1998","06","15","2021/2022","Midfielder","Southampton",410,245,165,"Mali",7,4,3,0,0,0,0,0,0,0,0,2,2,0,7,1,6,3,0,300,302,-1
"2831","Moussa Sissoko",32,"1989","08","16","2021/2022","Midfielder","Watford",971,450,521,"France",11,5,6,0,0,0,0,0,0,0,0,0,0,0,19,9,10,2,0,191,206,-1
"2832","N'Golo Kanté",30,"1991","03","29","2021/2022","Midfielder","Chelsea",497,145,352,"France",8,2,6,2,0,2,0,0,0,0,0,5,0,5,3,2,1,1,0,33,185,-1
"2833","Naby Deco Keïta",26,"1995","02","10","2021/2022","Midfielder","Liverpool",364,128,236,"Guinea",7,3,4,2,1,1,1,0,1,0,0,6,2,4,0,0,0,0,0,17,34,-1
"2834","Nathan Aké",26,"1995","02","18","2021/2022","Defender","Manchester City",284,194,90,"Netherlands",4,3,1,0,0,0,0,0,0,0,0,3,3,0,1,0,1,0,0,195,188,5
"2835","Nathan Broadhead",23,"1998","04","05","2021/2022","Forward","Everton",0,0,0,"Wales",0,0,0,0,0,0,0,0,0,0,0,0,0,0,0,0,0,0,0,-1,-1,-1
"2836","Nathan Michael Collins",20,"2001","04","30","2021/2022","Defender","Burnley",270,90,180,"Republic of Ireland",3,1,2,0,0,0,0,0,0,0,0,1,1,0,4,0,4,0,0,-1,-1,-1
"2837","Nathan Redmond",27,"1994","03","06","2021/2022","Midfielder","Southampton",683,333,350,"England",10,4,6,0,0,0,2,2,0,0,0,4,2,2,6,3,3,0,0,303,29,-1
"2838","Nathan Tella",22,"1999","07","05","2021/2022","Midfielder","Southampton",127,0,127,"England",4,1,3,0,0,0,0,0,0,0,0,1,1,0,3,0,3,0,0,-1,-1,-1
"2839","Nathaniel Clyne",30,"1991","04","05","2021/2022","Defender","Crystal Palace",0,0,0,"England",0,0,0,0,0,0,0,0,0,0,0,0,0,0,0,0,0,0,0,-1,-1,-1
"2840","Nathaniel Phillips",24,"1997","03","21","2021/2022","Defender","Liverpool",0,0,0,"England",0,0,0,0,0,0,0,0,0,0,0,0,0,0,0,0,0,0,0,-1,-1,-1
"2841","Neal Maupay",25,"1996","08","14","2021/2022","Forward","Brighton & Hove Albion",838,467,371,"France",12,7,5,4,2,2,0,0,0,1,0,5,3,2,11,7,4,3,0,27,220,-1
"2842","Neco Williams",20,"2001","04","13","2021/2022","Midfielder","Liverpool",7,0,7,"Wales",1,0,1,0,0,0,1,0,1,0,0,1,0,1,0,0,0,0,0,-1,-1,-1
"2843","Nélson Semedo",27,"1993","11","16","2021/2022","Defender","Wolverhampton Wanderers",1033,532,501,"Portugal",12,6,6,0,0,0,0,0,0,0,0,4,1,3,9,6,3,1,0,307,280,23
"2844","Nemanja Matić",33,"1988","08","01","2021/2022","Midfielder","Manchester United",472,110,362,"Serbia",8,2,6,0,0,0,2,0,2,0,0,1,0,1,7,1,6,0,0,249,14,-1
"2845","Nick Pope",29,"1992","04","19","2021/2022","Goalkeeper","Burnley",1080,540,540,"England",12,6,6,0,0,0,0,0,0,0,0,1,1,0,20,8,12,0,0,231,224,94
"2846","Nicolas N'Koulou",31,"1990","03","27","2021/2022","Defender","Watford",168,64,104,"Cameroon",3,1,2,0,0,0,0,0,0,0,0,0,0,0,2,1,1,0,0,-1,-1,-1
"2847","Nicolas Pépé",26,"1995","09","29","2021/2022","Forward","Arsenal",482,270,212,"Côte d'Ivoire",7,3,4,0,0,0,1,1,0,0,0,4,1,3,6,4,2,0,0,240,62,-1
"2848","Niels Nkounkou",21,"2000","11","01","2021/2022","Defender","Everton",0,0,0,"France",0,0,0,0,0,0,0,0,0,0,0,0,0,0,0,0,0,0,0,-1,-1,-1
"2849","Nikola Vlašić",24,"1997","10","04","2021/2022","Midfielder","West Ham United",126,68,58,"Croatia",5,1,4,0,0,0,0,0,0,0,0,1,0,1,1,1,0,0,0,-1,-1,-1
"2850","Nohan Kenneh",18,"2003","01","10","2021/2022","Midfielder","Leeds United",0,0,0,"England",0,0,0,0,0,0,0,0,0,0,0,0,0,0,0,0,0,0,0,-1,-1,-1
"2851","Nuno Albertino Varela Tavares",21,"2000","01","26","2021/2022","Defender","Arsenal",497,296,201,"Portugal",9,5,4,0,0,0,1,1,0,0,0,4,2,2,5,1,4,1,0,241,66,39
"2852","Odsonne Édouard",23,"1998","01","16","2021/2022","Forward","Crystal Palace",602,351,251,"France",11,6,5,3,2,1,0,0,0,0,0,3,2,1,7,4,3,0,0,22,178,-1
"2853","Oghenekaro Etebo",26,"1995","11","09","2021/2022","Forward","Watford",370,182,188,"Nigeria",6,3,3,0,0,0,0,0,0,0,0,0,0,0,5,2,3,3,0,267,272,-1
"2854","Ogochukwu Onyeka Frank",23,"1998","01","01","2021/2022","Midfielder","Brentford",658,396,262,"Nigeria",11,6,5,0,0,0,0,0,0,0,0,4,2,2,11,6,5,2,0,235,243,-1
"2855","Oleksandr Zinchenko",24,"1996","12","15","2021/2022","Midfielder","Manchester City",55,44,11,"Ukraine",2,1,1,0,0,0,0,0,0,0,0,1,1,0,0,0,0,0,0,-1,-1,-1
"2856","Oliver Skipp",21,"2000","09","16","2021/2022","Midfielder","Tottenham Hotspur",858,364,494,"England",11,5,6,0,0,0,0,0,0,0,0,4,2,2,8,3,5,5,0,188,202,-1
"2857","Ollie Watkins",25,"1995","12","30","2021/2022","Forward","Aston Villa",911,371,540,"England",11,5,6,3,2,1,0,0,0,0,0,3,2,1,14,6,8,2,0,47,175,-1
"2858","Onyinye Wilfred Ndidi",24,"1996","12","16","2021/2022","Midfielder","Leicester City",810,450,360,"Nigeria",9,5,4,0,0,0,0,0,0,0,0,1,1,0,16,8,8,2,0,310,311,-1
"2859","Oriol Romeu",30,"1991","09","24","2021/2022","Midfielder","Southampton",1103,503,600,"Spain",13,6,7,0,0,0,0,0,0,0,0,5,3,2,15,4,11,3,0,299,300,-1
"2860","Owen Beck",19,"2002","08","09","2021/2022","Midfielder","Liverpool",0,0,0,"Wales",0,0,0,0,0,0,0,0,0,0,0,0,0,0,0,0,0,0,0,-1,-1,-1
"2861","Owen Dodgson",18,"2003","03","19","2021/2022","Defender","Burnley",0,0,0,"England",0,0,0,0,0,0,0,0,0,0,0,0,0,0,0,0,0,0,0,-1,-1,-1
"2862","Ozan Muhammed Kabak",21,"2000","03","25","2021/2022","Defender","Norwich City",519,270,249,"Turkey",6,3,3,0,0,0,0,0,0,0,0,2,1,1,12,5,7,2,0,174,161,122
"2863","Ozan Tufan",26,"1995","03","23","2021/2022","Midfielder","Watford",273,44,229,"Turkey",5,1,4,0,0,0,0,0,0,0,0,0,0,0,5,0,5,0,0,161,197,-1
"2864","Pablo Fornals Malla",25,"1996","02","22","2021/2022","Midfielder","West Ham United",1124,537,587,"Spain",13,6,7,4,3,1,1,0,1,0,0,3,1,2,14,8,6,3,0,41,130,-1
"2865","Pablo Marí Villar",28,"1993","08","31","2021/2022","Defender","Arsenal",180,90,90,"Spain",2,1,1,0,0,0,0,0,0,0,0,0,0,0,4,2,2,1,0,-1,-1,-1
"2866","Paris Maghoma",0,"1970","01","01","2021/2022","Midfielder","Brentford",0,0,0,"England",0,0,0,0,0,0,0,0,0,0,0,0,0,0,0,0,0,0,0,-1,-1,-1
"2867","Pascal Groß",30,"1991","06","15","2021/2022","Midfielder","Brighton & Hove Albion",797,426,371,"Germany",10,5,5,0,0,0,2,1,1,0,0,4,3,1,8,5,3,0,0,213,45,-1
"2868","Pascal Struijk",22,"1999","08","11","2021/2022","Defender","Leeds United",867,373,494,"Netherlands",12,6,6,0,0,0,0,0,0,0,0,3,2,1,15,5,10,4,1,254,259,91
"2869","Patrick Bamford",28,"1993","09","05","2021/2022","Forward","Leeds United",437,180,257,"England",5,2,3,1,0,1,2,1,1,0,0,0,0,0,11,4,7,1,0,70,12,-1
"2870","Patrik Sigurður Gunnarsson",21,"2000","11","15","2021/2022","Goalkeeper","Brentford",0,0,0,"Iceland",0,0,0,0,0,0,0,0,0,0,0,0,0,0,0,0,0,0,0,-1,-1,-1
"2871","Patson Daka",23,"1998","10","09","2021/2022","Forward","Leicester City",103,33,70,"Zambia",4,2,2,1,1,0,1,0,1,0,0,0,0,0,4,1,3,0,0,-1,-1,-1
"2872","Paul Pogba",28,"1993","03","15","2021/2022","Midfielder","Manchester United",662,319,343,"France",9,5,4,0,0,0,7,6,1,0,0,1,0,1,9,4,5,5,1,246,1,-1
"2873","Phil Bardsley",36,"1985","06","28","2021/2022","Defender","Burnley",0,0,0,"Scotland",0,0,0,0,0,0,0,0,0,0,0,0,0,0,0,0,0,0,0,-1,-1,-1
"2874","Phil Jones",29,"1992","02","21","2021/2022","Defender","Manchester United",0,0,0,"England",0,0,0,0,0,0,0,0,0,0,0,0,0,0,0,0,0,0,0,-1,-1,-1
"2875","Philip Foden",21,"2000","05","28","2021/2022","Midfielder","Manchester City",613,256,357,"England",8,4,4,3,0,3,1,0,1,0,0,5,3,2,5,2,3,0,0,25,82,-1
"2876","Pierluigi Gollini",26,"1995","03","18","2021/2022","Goalkeeper","Tottenham Hotspur",0,0,0,"Italy",0,0,0,0,0,0,0,0,0,0,0,0,0,0,0,0,0,0,0,-1,-1,-1
"2877","Pierre Lees Melou",28,"1993","05","25","2021/2022","Midfielder","Norwich City",783,253,530,"France",10,3,7,0,0,0,0,0,0,0,0,2,1,1,17,4,13,3,0,282,286,-1
"2878","Pierre-Emerick Aubameyang",32,"1989","06","18","2021/2022","Forward","Arsenal",956,555,401,"Gabon",12,7,5,4,4,0,1,1,0,0,2,6,3,3,12,4,8,3,0,30,128,-1
"2879","Pierre-Emile Højbjerg",26,"1995","08","05","2021/2022","Midfielder","Tottenham Hotspur",1080,540,540,"Denmark",12,6,6,2,2,0,1,0,1,0,0,4,2,2,15,7,8,1,0,88,133,-1
"2880","Pontus Jansson",30,"1991","02","13","2021/2022","Defender","Brentford",1162,630,532,"Sweden",13,7,6,0,0,0,1,0,1,0,0,4,2,2,16,8,8,2,0,265,132,62
"2881","Przemysław Płacheta",23,"1998","03","23","2021/2022","Defender","Norwich City",2,2,0,"Poland",1,1,0,0,0,0,0,0,0,0,0,0,0,0,0,0,0,0,0,-1,-1,-1
"2882","Raheem Sterling",26,"1994","12","08","2021/2022","Forward","Manchester City",553,430,123,"England",11,7,4,2,2,0,0,0,0,0,0,7,5,2,3,1,2,0,0,38,171,-1
"2883","Raphael Dias Belloli",25,"1996","02","14","2021/2022","Forward","Leeds United",1000,573,427,"Brazil",12,7,5,6,4,2,0,0,0,1,0,3,2,1,15,7,8,3,0,11,261,-1
"2884","Raphaël Varane",28,"1993","04","25","2021/2022","Defender","Manchester United",540,270,270,"France",6,3,3,0,0,0,1,0,1,0,0,2,0,2,4,3,1,0,0,180,72,21
"2885","Raúl Alonso Jiménez Rodríguez",30,"1991","05","05","2021/2022","Forward","Wolverhampton Wanderers",1082,540,542,"Mexico",13,6,7,3,2,1,2,2,0,0,0,4,1,3,9,6,3,2,0,61,71,-1
"2886","Rayan Aït Nouri",20,"2001","06","06","2021/2022","Defender","Wolverhampton Wanderers",449,186,263,"France",6,3,3,0,0,0,1,1,0,0,0,2,1,1,3,1,2,1,0,319,57,19
"2887","Reece Hannam",21,"2000","09","19","2021/2022","Defender","Crystal Palace",0,0,0,"England",0,0,0,0,0,0,0,0,0,0,0,0,0,0,0,0,0,0,0,-1,-1,-1
"2888","Reece James",21,"1999","12","08","2021/2022","Defender","Chelsea",638,322,316,"England",10,5,5,4,1,3,4,1,3,0,0,6,2,4,2,2,0,3,1,9,5,2
"2889","Reece Welch",18,"2003","09","19","2021/2022","Defender","Everton",0,0,0,"England",0,0,0,0,0,0,0,0,0,0,0,0,0,0,0,0,0,0,0,-1,-1,-1
"2890","Reiss Nelson",21,"1999","12","10","2021/2022","Forward","Arsenal",19,0,19,"England",1,0,1,0,0,0,0,0,0,0,0,0,0,0,1,0,1,0,0,-1,-1,-1
"2891","Remi Matthews",27,"1994","02","10","2021/2022","Goalkeeper","Crystal Palace",0,0,0,"England",0,0,0,0,0,0,0,0,0,0,0,0,0,0,0,0,0,0,0,-1,-1,-1
"2892","Ricardo Domingos Barbosa Pereira",28,"1993","10","06","2021/2022","Defender","Leicester City",597,226,371,"Portugal",8,3,5,0,0,0,2,1,1,0,0,1,1,0,12,4,8,1,0,306,21,106
"2893","Richarlison de Andrade",24,"1997","05","10","2021/2022","Forward","Everton",650,290,360,"Brazil",8,4,4,2,2,0,1,1,0,0,0,2,1,1,12,5,7,5,0,51,91,-1
"2894","Rico Henry",24,"1997","07","08","2021/2022","Defender","Brentford",1121,596,525,"England",13,7,6,2,1,1,0,0,0,0,0,4,2,2,16,8,8,1,0,92,241,65
"2895","Riyad Mahrez",30,"1991","02","21","2021/2022","Midfielder","Manchester City",382,291,91,"Algeria",10,7,3,2,1,1,1,1,0,0,0,6,5,1,2,1,1,0,0,20,37,-1
"2896","Rob Elliot",35,"1986","04","30","2021/2022","Goalkeeper","Watford",0,0,0,"Republic of Ireland",0,0,0,0,0,0,0,0,0,0,0,0,0,0,0,0,0,0,0,-1,-1,-1
"2897","Rob Holding",26,"1995","09","20","2021/2022","Defender","Arsenal",180,90,90,"England",2,1,1,0,0,0,0,0,0,0,0,0,0,0,7,2,5,1,0,-1,-1,-1
"2898","Robert Lynch Sanchez",23,"1997","11","18","2021/2022","Goalkeeper","Brighton & Hove Albion",1080,630,450,"Spain",12,7,5,0,0,0,0,0,0,0,0,5,3,2,11,7,4,3,1,210,216,40
"2899","Robert Street",20,"2001","09","26","2021/2022","Forward","Crystal Palace",0,0,0,"England",0,0,0,0,0,0,0,0,0,0,0,0,0,0,0,0,0,0,0,-1,-1,-1
"2900","Roberto Firmino",30,"1991","10","02","2021/2022","Forward","Liverpool",369,152,217,"Brazil",8,4,4,4,0,4,1,0,1,0,0,4,1,3,6,5,1,0,0,2,38,-1
"2901","Robin Koch",25,"1996","07","17","2021/2022","Defender","Leeds United",90,0,90,"Germany",1,0,1,0,0,0,0,0,0,0,0,0,0,0,5,0,5,0,0,-1,-1,-1
"2902","Rodri",25,"1996","06","22","2021/2022","Midfielder","Manchester City",990,540,450,"Spain",11,6,5,2,2,0,0,0,0,0,0,7,4,3,5,2,3,2,0,85,174,-1
"2903","Rodrigo",30,"1991","03","06","2021/2022","Forward","Leeds United",901,450,451,"Spain",12,6,6,2,1,1,0,0,0,1,0,3,2,1,9,4,5,4,0,74,260,-1
"2904","Romain Perraud",24,"1997","09","22","2021/2022","Defender","Southampton",524,349,175,"France",7,4,3,0,0,0,0,0,0,0,0,3,2,1,10,3,7,0,0,297,297,100
"2905","Romain Saïss",31,"1990","03","26","2021/2022","Midfielder","Wolverhampton Wanderers",1120,490,630,"Morocco",13,6,7,1,0,1,0,0,0,0,0,4,1,3,11,6,5,3,0,147,318,-1
"2906","Romelu Lukaku",28,"1993","05","13","2021/2022","Forward","Chelsea",624,278,346,"Belgium",8,4,4,3,2,1,0,0,0,0,0,4,1,3,3,2,1,0,0,26,186,-1
"2907","Roméo Lavia",17,"2004","01","06","2021/2022","Midfielder","Manchester City",0,0,0,"Belgium",0,0,0,0,0,0,0,0,0,0,0,0,0,0,0,0,0,0,0,-1,-1,-1
"2908","Rondon",32,"1989","09","16","2021/2022","Forward","Everton",549,279,270,"Venezuela",9,4,5,0,0,0,0,0,0,0,0,1,1,0,8,5,3,2,0,176,153,-1
"2909","Ross Barkley",27,"1993","12","05","2021/2022","Midfielder","Chelsea",126,100,26,"England",4,3,1,0,0,0,0,0,0,0,0,2,1,1,0,0,0,0,0,-1,-1,-1
"2910","Rúben Diogo Da Silva Neves",24,"1997","03","13","2021/2022","Midfielder","Wolverhampton Wanderers",993,540,453,"Portugal",13,6,7,1,0,1,0,0,0,0,0,4,1,3,11,6,5,5,0,125,319,-1
"2911","Ruben Loftus-Cheek",25,"1996","01","23","2021/2022","Midfielder","Chelsea",359,230,129,"England",8,5,3,0,0,0,2,2,0,0,0,4,1,3,3,3,0,0,0,165,7,-1
"2912","Rúben Santos Gato Alves Dias",24,"1997","05","14","2021/2022","Defender","Manchester City",1008,468,540,"Portugal",12,6,6,0,0,0,1,1,0,0,0,7,4,3,6,2,4,2,0,196,123,18
"2913","Ryan Bertrand",32,"1989","08","05","2021/2022","Defender","Leicester City",338,180,158,"England",4,2,2,0,0,0,0,0,0,0,0,0,0,0,7,3,4,1,0,169,193,109
"2914","Ryan Fraser",27,"1994","02","24","2021/2022","Midfielder","Newcastle United",319,163,156,"Scotland",10,7,3,0,0,0,1,1,0,0,0,0,0,0,4,1,3,0,0,149,25,-1
"2915","Ryan Fredericks",29,"1992","10","10","2021/2022","Midfielder","West Ham United",2,0,2,"England",1,0,1,0,0,0,0,0,0,0,0,0,0,0,0,0,0,0,0,-1,-1,-1
"2916","Ryan Sessegnon",21,"2000","05","18","2021/2022","Defender","Tottenham Hotspur",11,11,0,"England",1,1,0,0,0,0,0,0,0,0,0,0,0,0,0,0,0,0,0,-1,-1,-1
"2917","Sadio Mané",29,"1992","04","10","2021/2022","Forward","Liverpool",1094,630,464,"Senegal",13,7,6,7,5,2,1,1,0,0,0,8,4,4,11,5,6,1,0,8,136,-1
"2918","Sam Greenwood",0,"1970","01","01","2021/2022","Defender","Leeds United",0,0,0,"England",0,0,0,0,0,0,0,0,0,0,0,0,0,0,0,0,0,0,0,-1,-1,-1
"2919","Saman Ghoddos",28,"1993","11","03","2021/2022","Forward","Brentford",253,76,177,"Sweden",7,3,4,1,0,1,1,1,0,0,0,1,0,1,3,0,3,2,0,-1,-1,-1
"2920","Samuel Edozie",0,"1970","01","01","2021/2022","Forward","Manchester City",0,0,0,"England",0,0,0,0,0,0,0,0,0,0,0,0,0,0,0,0,0,0,0,-1,-1,-1
"2921","Saúl Ñíguez",26,"1994","11","21","2021/2022","Midfielder","Chelsea",48,46,2,"Spain",2,1,1,0,0,0,0,0,0,0,0,2,1,1,0,0,0,0,0,-1,-1,-1
"2922","Scott Banks",20,"2001","01","01","2021/2022","Midfielder","Crystal Palace",0,0,0,"Scotland",0,0,0,0,0,0,0,0,0,0,0,0,0,0,0,0,0,0,0,-1,-1,-1
"2923","Scott Carson",36,"1985","09","03","2021/2022","Goalkeeper","Manchester City",0,0,0,"England",0,0,0,0,0,0,0,0,0,0,0,0,0,0,0,0,0,0,0,-1,-1,-1
"2924","Scott McTominay",24,"1996","12","08","2021/2022","Midfielder","Manchester United",761,421,340,"England",11,5,6,0,0,0,0,0,0,0,0,1,0,1,14,9,5,2,0,248,253,-1
"2925","Sead Kolašinac",28,"1993","06","20","2021/2022","Defender","Arsenal",90,0,90,"Bosnia and Herzegovina",2,0,2,0,0,0,0,0,0,0,0,1,0,1,5,0,5,1,0,-1,-1,-1
"2926","Séamus Coleman",33,"1988","10","11","2021/2022","Defender","Everton",900,450,450,"Republic of Ireland",10,5,5,0,0,0,0,0,0,0,0,2,1,1,15,7,8,2,0,229,234,83
"2927","Sean Longstaff",24,"1997","10","30","2021/2022","Midfielder","Newcastle United",726,346,380,"England",11,6,5,1,0,1,0,0,0,0,0,0,0,0,15,7,8,1,0,108,165,-1
"2928","Sergi Canós Tenes",24,"1997","02","02","2021/2022","Midfielder","Brentford",1085,580,505,"Spain",13,7,6,1,1,0,2,0,2,0,0,4,2,2,16,8,8,4,0,135,75,-1
"2929","Sergio Reguilón Rodríguez",24,"1996","12","16","2021/2022","Defender","Tottenham Hotspur",954,439,515,"Spain",11,5,6,1,1,0,2,0,2,0,0,4,2,2,12,4,8,1,0,124,65,53
"2930","Shandon Baptiste",23,"1998","04","08","2021/2022","Midfielder","Brentford",212,117,95,"Grenada",7,3,4,0,0,0,0,0,0,0,0,2,1,1,0,0,0,2,1,-1,-1,-1
"2931","Shane Duffy",29,"1992","01","01","2021/2022","Defender","Brighton & Hove Albion",990,450,540,"Republic of Ireland",11,5,6,1,1,0,0,0,0,0,0,4,2,2,10,4,6,4,0,130,218,38
"2932","Shane Long",34,"1987","01","22","2021/2022","Forward","Southampton",16,16,0,"Republic of Ireland",1,1,0,0,0,0,0,0,0,0,0,0,0,0,0,0,0,0,0,-1,-1,-1
"2933","Solomon March",27,"1994","07","20","2021/2022","Midfielder","Brighton & Hove Albion",565,327,238,"England",11,6,5,0,0,0,1,0,1,0,0,5,3,2,9,4,5,1,0,214,81,-1
"2934","Steven Alzate",23,"1998","09","08","2021/2022","Midfielder","Brighton & Hove Albion",91,0,91,"England",2,0,2,0,0,0,0,0,0,0,0,0,0,0,1,0,1,0,0,-1,-1,-1
"2935","Steven Bergwijn",24,"1997","10","08","2021/2022","Forward","Tottenham Hotspur",271,181,90,"Netherlands",5,3,2,0,0,0,1,1,0,0,0,3,2,1,2,2,0,0,0,189,17,-1
"2936","Stuart Armstrong",29,"1992","03","30","2021/2022","Midfielder","Southampton",123,103,20,"Scotland",4,3,1,0,0,0,0,0,0,0,0,3,2,1,0,0,0,0,0,-1,-1,-1
"2937","Stuart Dallas",30,"1991","04","19","2021/2022","Midfielder","Leeds United",1248,618,630,"Northern Ireland",14,7,7,0,0,0,1,0,1,0,0,3,2,1,18,7,11,1,0,253,145,-1
"2938","Stuart McKinstry",19,"2002","09","18","2021/2022","Midfielder","Leeds United",3,0,3,"Scotland",1,0,1,0,0,0,0,0,0,0,0,0,0,0,0,0,0,0,0,-1,-1,-1
"2939","Takehiro Tomiyasu",23,"1998","11","05","2021/2022","Defender","Arsenal",872,512,360,"Japan",10,6,4,0,0,0,1,1,0,0,0,6,3,3,8,4,4,1,0,173,110,28
"2940","Takumi Minamino",26,"1995","01","16","2021/2022","Forward","Liverpool",36,26,10,"Japan",4,3,1,1,1,0,0,0,0,0,0,2,2,0,0,0,0,1,0,-1,-1,-1
"2941","Tammy Abraham",24,"1997","10","02","2021/2022","Forward","Chelsea",0,0,0,"England",0,0,0,0,0,0,0,0,0,0,0,0,0,0,0,0,0,0,0,-1,-1,-1
"2942","Tanguy Ndombele",24,"1996","12","28","2021/2022","Midfielder","Tottenham Hotspur",411,162,249,"France",7,3,4,1,0,1,0,0,0,0,0,1,0,1,10,4,6,1,0,66,205,-1
"2943","Tariq Lamptey",21,"2000","09","30","2021/2022","Midfielder","Brighton & Hove Albion",318,184,134,"England",6,3,3,0,0,0,0,0,0,0,0,2,1,1,1,1,0,1,0,320,320,-1
"2944","Tarique Fosu",26,"1995","11","05","2021/2022","Midfielder","Brentford",0,0,0,"England",0,0,0,0,0,0,0,0,0,0,0,0,0,0,0,0,0,0,0,-1,-1,-1
"2945","Taylor Richards",20,"2000","12","04","2021/2022","Midfielder","Brighton & Hove Albion",17,17,0,"England",1,1,0,0,0,0,0,0,0,0,0,0,0,0,0,0,0,0,0,-1,-1,-1
"2946","Teemu Pukki",31,"1990","03","29","2021/2022","Forward","Norwich City",1195,600,595,"Finland",14,7,7,5,3,2,0,0,0,2,0,3,2,1,25,10,15,1,0,31,288,-1
"2947","Theo Walcott",32,"1989","03","16","2021/2022","Forward","Southampton",283,129,154,"England",6,3,3,0,0,0,0,0,0,0,0,1,1,0,6,2,4,0,0,301,303,-1
"2948","Thiago Alcantara",30,"1991","04","11","2021/2022","Midfielder","Liverpool",342,230,112,"Spain",7,5,2,1,1,0,1,0,1,0,0,5,4,1,1,0,1,0,0,58,30,-1
"2949","Thiago Silva",37,"1984","09","22","2021/2022","Defender","Chelsea",825,511,314,"Brazil",10,6,4,1,0,1,0,0,0,0,0,5,2,3,4,4,0,1,0,116,227,12
"2950","Thomas Doyle",20,"2001","10","17","2021/2022","Midfielder","Manchester City",0,0,0,"England",0,0,0,0,0,0,0,0,0,0,0,0,0,0,0,0,0,0,0,-1,-1,-1
"2951","Thomas Partey",28,"1993","06","13","2021/2022","Midfielder","Arsenal",713,374,339,"Ghana",9,5,4,1,1,0,0,0,0,0,0,5,2,3,8,4,4,1,0,103,163,-1
"2952","Tim Krul",33,"1988","04","03","2021/2022","Goalkeeper","Norwich City",1260,630,630,"Netherlands",14,7,7,0,0,0,0,0,0,0,0,3,2,1,27,11,16,1,0,263,282,117
"2953","Timo Werner",25,"1996","03","06","2021/2022","Forward","Chelsea",470,360,110,"Germany",8,5,3,1,1,0,1,0,1,0,0,5,2,3,3,3,0,1,0,79,60,-1
"2954","Timothy Castagne",25,"1995","12","05","2021/2022","Defender","Leicester City",865,494,371,"Belgium",11,6,5,0,0,0,0,0,0,0,0,0,0,0,15,10,5,0,0,162,183,90
"2955","Tobi Omole",21,"1999","12","17","2021/2022","Defender","Tottenham Hotspur",0,0,0,"England",0,0,0,0,0,0,0,0,0,0,0,0,0,0,0,0,0,0,0,-1,-1,-1
"2956","Todd Cantwell",23,"1998","02","27","2021/2022","Midfielder","Norwich City",360,242,118,"England",6,4,2,0,0,0,0,0,0,0,0,0,0,0,13,7,6,2,0,283,287,-1
"2957","Tom Cleverley",32,"1989","08","12","2021/2022","Midfielder","Watford",540,303,237,"England",9,5,4,0,0,0,1,1,0,0,0,0,0,0,11,5,6,0,0,202,73,-1
"2958","Tom Davies",23,"1998","06","30","2021/2022","Midfielder","Everton",154,127,27,"England",5,3,2,1,1,0,0,0,0,0,0,2,2,0,4,4,0,0,0,-1,-1,-1
"2959","Tom Heaton",35,"1986","04","15","2021/2022","Goalkeeper","Manchester United",0,0,0,"England",0,0,0,0,0,0,0,0,0,0,0,0,0,0,0,0,0,0,0,-1,-1,-1
"2960","Tomáš Souček",26,"1995","02","27","2021/2022","Midfielder","West Ham United",1159,540,619,"Czech Republic",13,6,7,1,0,1,1,1,0,0,0,3,1,2,14,8,6,2,0,141,131,-1
"2961","Trent Alexander-Arnold",23,"1998","10","07","2021/2022","Defender","Liverpool",964,450,514,"England",11,5,6,1,0,1,7,4,3,0,0,7,3,4,9,3,6,1,0,126,2,29
"2962","Trevoh Chalobah",22,"1999","07","05","2021/2022","Defender","Chelsea",633,450,183,"England",8,5,3,2,2,0,0,0,0,0,0,5,3,2,2,2,0,0,0,52,223,3
"2963","Troy Deeney",33,"1988","06","29","2021/2022","Forward","Watford",23,11,12,"England",2,1,1,0,0,0,0,0,0,0,0,0,0,0,0,0,0,0,0,-1,-1,-1
"2964","Tyler Morton",19,"2002","10","31","2021/2022","Midfielder","Liverpool",6,6,0,"England",1,1,0,0,0,0,0,0,0,0,0,1,1,0,0,0,0,0,0,-1,-1,-1
"2965","Tyler Onyango",18,"2003","03","04","2021/2022","Midfielder","Everton",0,0,0,"England",1,0,1,0,0,0,0,0,0,0,0,0,0,0,0,0,0,0,0,-1,-1,-1
"2966","Tyler Roberts",22,"1999","01","12","2021/2022","Forward","Leeds United",435,248,187,"Wales",14,7,7,0,0,0,0,0,0,0,0,3,2,1,2,1,1,3,0,257,263,-1
"2967","Tyrick Mitchell",22,"1999","09","01","2021/2022","Defender","Crystal Palace",1260,630,630,"England",14,7,7,0,0,0,1,1,0,0,0,4,3,1,17,5,12,0,0,223,147,58
"2968","Tyrone Mings",28,"1993","03","13","2021/2022","Defender","Aston Villa",1028,398,630,"England",12,5,7,1,1,0,1,1,0,0,0,4,3,1,15,4,11,4,0,129,118,69
"2969","Valentino Livramento",19,"2002","11","12","2021/2022","Defender","Southampton",1166,540,626,"England",13,6,7,1,1,0,0,0,0,0,0,5,3,2,17,4,13,1,0,145,298,68
"2970","Vicente Guaita",34,"1987","01","10","2021/2022","Goalkeeper","Crystal Palace",1260,630,630,"Spain",14,7,7,0,0,0,0,0,0,0,0,4,3,1,17,5,12,1,0,221,229,60
"2971","Victor Nilsson Lindelöf",27,"1994","07","17","2021/2022","Defender","Manchester United",834,384,450,"Sweden",10,5,5,0,0,0,2,1,1,0,0,1,0,1,17,10,7,1,0,243,55,107
"2972","Viljani Sinisalo",20,"2001","10","11","2021/2022","Goalkeeper","Aston Villa",0,0,0,"Finland",0,0,0,0,0,0,0,0,0,0,0,0,0,0,0,0,0,0,0,-1,-1,-1
"2973","Virgil van Dijk",30,"1991","07","08","2021/2022","Defender","Liverpool",1170,630,540,"Netherlands",13,7,6,1,1,0,1,1,0,0,0,8,4,4,11,5,6,0,0,134,137,30
"2974","Vitaly Janelt",23,"1998","05","10","2021/2022","Midfielder","Brentford",761,384,377,"Germany",10,5,5,1,1,0,0,0,0,0,0,4,2,2,9,5,4,1,0,105,242,-1
"2975","Vladimír Coufal",29,"1992","08","22","2021/2022","Defender","West Ham United",665,366,299,"Czech Republic",10,5,5,0,0,0,1,1,0,0,0,1,0,1,9,6,3,0,0,181,88,61
"2976","Wayne Hennessey",34,"1987","01","24","2021/2022","Goalkeeper","Burnley",0,0,0,"Wales",0,0,0,0,0,0,0,0,0,0,0,0,0,0,0,0,0,0,0,-1,-1,-1
"2977","Wesley Moraes Ferreira da Silva",24,"1996","11","26","2021/2022","Forward","Aston Villa",0,0,0,"Brazil",1,1,0,0,0,0,0,0,0,0,0,1,1,0,0,0,0,0,0,-1,-1,-1
"2978","Wilfried Zaha",28,"1992","11","10","2021/2022","Midfielder","Crystal Palace",1085,545,540,"Côte d'Ivoire",13,7,6,4,3,1,1,1,0,2,0,4,3,1,14,3,11,3,0,37,142,-1
"2979","Will Hughes",26,"1995","04","17","2021/2022","Midfielder","Crystal Palace",10,0,10,"England",1,0,1,0,0,0,0,0,0,0,0,0,0,0,0,0,0,0,0,-1,-1,-1
"2980","Will Norris",28,"1993","08","12","2021/2022","Goalkeeper","Burnley",0,0,0,"England",0,0,0,0,0,0,0,0,0,0,0,0,0,0,0,0,0,0,0,-1,-1,-1
"2981","William Smallbone",21,"2000","02","21","2021/2022","Midfielder","Southampton",0,0,0,"England",0,0,0,0,0,0,0,0,0,0,0,0,0,0,0,0,0,0,0,-1,-1,-1
"2982","William Troost-Ekong",28,"1993","09","01","2021/2022","Defender","Watford",1016,476,540,"Nigeria",12,6,6,0,0,0,0,0,0,0,0,0,0,0,20,9,11,2,0,290,268,102
"2983","Willy Boly",30,"1991","02","03","2021/2022","Defender","Wolverhampton Wanderers",0,0,0,"France",0,0,0,0,0,0,0,0,0,0,0,0,0,0,0,0,0,0,0,-1,-1,-1
"2984","Yann Valery",22,"1999","02","22","2021/2022","Defender","Southampton",0,0,0,"France",0,0,0,0,0,0,0,0,0,0,0,0,0,0,0,0,0,0,0,-1,-1,-1
"2985","Yerry Fernando Mina González",27,"1994","09","23","2021/2022","Defender","Everton",457,187,270,"Colombia",6,3,3,0,0,0,0,0,0,0,0,1,1,0,7,1,6,1,0,292,238,76
"2986","Yerson Mosquera Valdelamar",20,"2001","05","02","2021/2022","Midfielder","Wolverhampton Wanderers",0,0,0,"Colombia",0,0,0,0,0,0,0,0,0,0,0,0,0,0,0,0,0,0,0,-1,-1,-1
"2987","Yoane Wissa",25,"1996","09","03","2021/2022","Forward","Brentford",60,15,45,"France",5,2,3,2,1,1,0,0,0,0,0,2,1,1,0,0,0,0,0,-1,-1,-1
"2988","Youri Tielemans",24,"1997","05","07","2021/2022","Midfielder","Leicester City",977,450,527,"Belgium",11,5,6,3,1,2,2,1,1,0,0,1,1,0,18,7,11,1,0,49,68,-1
"2989","Yves Bissouma",25,"1996","08","30","2021/2022","Midfielder","Brighton & Hove Albion",769,439,330,"Mali",9,5,4,0,0,0,1,1,0,0,0,3,2,1,9,4,5,3,0,215,101,-1
"2990","Zack Steffen",26,"1995","04","02","2021/2022","Goalkeeper","Manchester City",90,90,0,"USA",1,1,0,0,0,0,0,0,0,0,0,1,1,0,0,0,0,0,0,-1,-1,-1
"2991","Łukasz Fabiański",36,"1985","04","18","2021/2022","Goalkeeper","West Ham United",1170,540,630,"Poland",13,6,7,0,0,0,0,0,0,0,0,3,1,2,14,8,6,0,0,152,150,50
